Id,Label,timeset,modularity_class,indegree,outdegree,Degree,weighted indegree,weighted outdegree,Weighted Degree,Eccentricity,closnesscentrality,harmonicclosnesscentrality,betweenesscentrality,Authority,Hub,clustering
1,1,,0,1,1,2,1,1,2,11,0.222205,0.233439,0,0.000065,0.000067,0
5,5,,0,31,32,63,38,39,77,10,0.285658,0.311974,0.019699,0.004156,0.004079,0.07197
2,2,,0,5,4,9,6,5,11,11,0.222256,0.233958,0.000001,0.00007,0.00007,0.55
4,4,,0,5,5,10,6,6,12,11,0.222274,0.234132,0,0.00007,0.000071,0.6
6,6,,0,3,4,7,4,5,9,11,0.222256,0.233958,0.000334,0.000067,0.00007,0.5
5430,5430,,0,4,4,8,4,4,8,11,0.222256,0.233958,0,0.000069,0.00007,0.666667
3,3,,0,5,4,9,7,6,13,11,0.222256,0.233958,0.000001,0.00007,0.00007,0.466667
5431,5431,,0,2,2,4,2,2,4,11,0.222222,0.233612,0,0.000067,0.000068,1
5434,5434,,0,3,3,6,4,5,9,11,0.222239,0.233785,0,0.000068,0.000069,0.833333
5424,5424,,0,3,3,6,3,3,6,11,0.222239,0.233785,0,0.000068,0.000069,1
5435,5435,,0,6,6,12,7,6,13,11,0.222291,0.234305,0.000001,0.000071,0.000072,0.4
2279,2279,,30,84,87,171,167,170,337,9,0.367363,0.408509,0.030963,0.064973,0.06731,0.25209
2397,2397,,30,74,76,150,157,159,316,9,0.334144,0.371412,0.024807,0.024953,0.026877,0.130351
3077,3077,,30,111,112,223,232,232,464,9,0.363889,0.409277,0.023356,0.065821,0.066018,0.225949
3316,3316,,30,112,113,225,245,246,491,9,0.360255,0.406425,0.03223,0.059928,0.060367,0.169169
3320,3320,,30,51,50,101,86,87,173,10,0.322999,0.354347,0.03152,0.012101,0.012058,0.170196
3322,3322,,30,22,23,45,33,32,65,10,0.282858,0.306349,0.00634,0.004168,0.004178,0.208333
3361,3361,,30,77,77,154,143,142,285,9,0.334376,0.369853,0.028702,0.020283,0.020247,0.12218
4074,4074,,0,22,25,47,24,26,50,11,0.246603,0.265141,0.014312,0.000357,0.00036,0.041667
5419,5419,,0,2,2,4,2,2,4,11,0.222222,0.233612,0,0.000067,0.000068,1
5420,5420,,0,1,1,2,1,1,2,11,0.222205,0.233439,0,0.000065,0.000067,0
5421,5421,,0,4,3,7,4,3,7,11,0.222256,0.233843,0.000669,0.000068,0.000068,0.333333
5422,5422,,0,2,2,4,3,3,6,11,0.222239,0.23367,0.000669,0.000065,0.000067,0
5423,5423,,0,2,2,4,3,3,6,11,0.222222,0.233612,0.000334,0.000065,0.000068,0.5
5425,5425,,0,3,4,7,4,4,8,11,0.222274,0.234016,0,0.000068,0.00007,0.666667
5427,5427,,0,1,2,3,1,2,3,11,0.222239,0.23367,0,0.000065,0.000068,1
5428,5428,,0,3,3,6,3,3,6,11,0.222239,0.233785,0,0.000068,0.000069,0.666667
5429,5429,,0,1,1,2,1,1,2,11,0.222205,0.233439,0,0.000065,0.000067,0
5433,5433,,0,1,1,2,1,1,2,11,0.222205,0.233439,0,0.000065,0.000067,0
5436,5436,,0,2,1,3,2,1,3,12,0.181853,0.188036,0,0.000067,0.000001,1
5437,5437,,0,1,1,2,1,1,2,11,0.222205,0.233439,0,0.000065,0.000067,0
5979,5979,,0,2,2,4,2,3,5,11,0.222222,0.233612,0,0.000067,0.000068,1
5984,5984,,0,2,1,3,2,1,3,12,0.18183,0.18792,0,0.000067,0.000001,1
7,7,,1,6,6,12,6,6,12,11,0.210166,0.219544,0.00202,0.000041,0.000042,0.3
8,8,,1,9,8,17,9,8,17,10,0.243935,0.257438,0.003794,0.000544,0.000527,0.25
9,9,,1,7,8,15,8,8,16,10,0.263057,0.280397,0.007817,0.001927,0.001932,0.321429
18,18,,1,9,9,18,9,9,18,11,0.212237,0.223743,0.002706,0.000109,0.000078,0.144444
5440,5440,,1,2,2,4,2,2,4,11,0.196166,0.203146,0,0.000009,0.000009,1
5442,5442,,1,3,3,6,3,3,6,12,0.173709,0.179118,0.000669,0.000001,0.000001,0.333333
5445,5445,,1,2,2,4,2,2,4,12,0.173698,0.178945,0,0.000001,0.000001,1
16,16,,5,22,22,44,25,25,50,9,0.321023,0.349739,0.005691,0.030678,0.031731,0.492095
4248,4248,,1,4,4,8,4,4,8,11,0.196353,0.203948,0.000735,0.00001,0.000011,0.333333
5443,5443,,1,2,2,4,2,2,4,11,0.209967,0.218361,0,0.000039,0.00004,1
5447,5447,,1,4,4,8,4,4,8,11,0.210074,0.218967,0.000006,0.000041,0.000041,0.75
609,609,,5,114,114,228,171,171,342,9,0.354982,0.398657,0.01894,0.119558,0.119369,0.283143
3995,3995,,1,8,8,16,8,9,17,11,0.210151,0.219718,0.00243,0.000033,0.000041,0.319444
3997,3997,,1,6,6,12,6,6,12,11,0.208436,0.217598,0.000911,0.000032,0.000032,0.466667
11,11,,1,1,1,2,1,1,2,12,0.175089,0.181087,0,0.000001,0.000002,0
12,12,,1,1,1,2,1,1,2,12,0.175089,0.181087,0,0.000001,0.000002,0
15,15,,1,1,1,2,1,1,2,12,0.175089,0.181087,0,0.000001,0.000002,0
193,193,,2,118,116,234,167,166,333,9,0.378492,0.421031,0.043086,0.0822,0.082583,0.175687
337,337,,5,70,69,139,77,76,153,10,0.31271,0.35246,0.000851,0.071508,0.070944,0.313872
340,340,,5,236,237,473,352,349,701,9,0.402454,0.460157,0.069411,0.182408,0.182176,0.129094
421,421,,5,80,81,161,126,128,254,9,0.343776,0.382787,0.012952,0.084317,0.085618,0.283499
478,478,,5,124,117,241,198,194,392,9,0.343449,0.387985,0.010489,0.10728,0.104987,0.183845
502,502,,5,169,170,339,265,262,527,9,0.346375,0.400596,0.015407,0.125019,0.122768,0.132157
507,507,,5,158,157,315,289,288,577,9,0.393724,0.441862,0.043447,0.144525,0.143383,0.202372
548,548,,5,139,138,277,151,153,304,10,0.314516,0.359281,0.007138,0.076578,0.07567,0.118757
580,580,,5,194,201,395,292,300,592,9,0.388478,0.443003,0.040468,0.164757,0.166784,0.147416
625,625,,5,5,5,10,5,5,10,10,0.268315,0.288157,0.00241,0.004251,0.004252,0.5
644,644,,5,90,90,180,133,133,266,9,0.332834,0.374187,0.01908,0.086907,0.086934,0.259585
679,679,,5,78,78,156,102,102,204,9,0.331534,0.371031,0.002516,0.086233,0.086268,0.346487
737,737,,5,105,104,209,145,145,290,9,0.344022,0.387338,0.019391,0.099003,0.09906,0.235165
1212,1212,,5,91,91,182,137,138,275,9,0.316343,0.358434,0.003215,0.070144,0.070113,0.197924
1382,1382,,5,213,213,426,331,331,662,9,0.395342,0.45079,0.068304,0.164318,0.166074,0.137128
3448,3448,,2,87,87,174,123,125,248,9,0.334299,0.371753,0.009197,0.056253,0.056162,0.279604
3494,3494,,2,108,107,215,140,139,279,9,0.371763,0.41409,0.018311,0.092109,0.091677,0.244116
3577,3577,,2,63,64,127,97,98,195,9,0.345505,0.378791,0.03747,0.04244,0.042318,0.350198
3797,3797,,2,139,143,282,239,241,480,9,0.385159,0.432204,0.037186,0.10997,0.111463,0.184926
4167,4167,,2,34,34,68,35,34,69,10,0.269594,0.295548,0.004508,0.006862,0.006961,0.013369
5439,5439,,1,2,2,4,2,2,4,12,0.175111,0.181318,0,0.000001,0.000002,1
21,21,,4,2,2,4,2,2,4,11,0.218421,0.226793,0,0.00004,0.00004,1
121,121,,4,11,11,22,12,12,24,10,0.278787,0.29659,0.013649,0.002186,0.002158,0.108974
133,133,,4,6,6,12,6,6,12,11,0.239383,0.252161,0.004726,0.000323,0.000327,0.266667
24,24,,3,2,2,4,3,3,6,11,0.220104,0.229057,0.000271,0.000054,0.000054,0
189,189,,2,9,10,19,12,13,25,10,0.281974,0.30119,0.003771,0.003341,0.003343,0.333333
5485,5485,,3,3,3,6,4,4,8,12,0.180816,0.186815,0.000082,0.000002,0.000002,0
27,27,,3,2,2,4,2,2,4,10,0.230695,0.240878,0,0.000116,0.000116,1
111,111,,3,14,14,28,15,15,30,9,0.299533,0.322639,0.005503,0.007089,0.007065,0.208791
192,192,,3,4,4,8,4,4,8,10,0.231009,0.241796,0.000004,0.000143,0.000143,0.5
28,28,,3,3,3,6,4,3,7,10,0.253848,0.268068,0.000089,0.000801,0.000807,0.333333
71,71,,3,5,4,9,5,4,9,10,0.230806,0.241554,0.00134,0.000139,0.000139,0.1
146,146,,2,70,67,137,93,92,185,9,0.339569,0.375906,0.030171,0.049193,0.048819,0.179296
202,202,,3,9,9,18,11,11,22,10,0.254251,0.269604,0.00398,0.000928,0.000934,0.222222
29,29,,3,4,3,7,5,4,9,12,0.19433,0.201568,0.000013,0.000006,0.000005,0.5
132,132,,3,10,10,20,16,17,33,11,0.228793,0.241541,0.003025,0.00013,0.00013,0.211111
147,147,,3,4,3,7,4,3,7,12,0.186278,0.193027,0.000006,0.000002,0.000002,0.333333
196,196,,3,15,15,30,22,23,45,11,0.2399,0.25312,0.011214,0.00021,0.00021,0.080952
30,30,,2,2,2,4,4,4,8,11,0.255172,0.268194,0,0.000579,0.000581,1
119,119,,2,5,5,10,7,7,14,11,0.259322,0.273934,0.000006,0.001523,0.001524,0.7
156,156,,2,59,58,117,88,85,173,10,0.342511,0.37657,0.020416,0.034693,0.034563,0.228229
32,32,,3,5,5,10,7,7,14,12,0.1936,0.200676,0.000985,0.000004,0.000004,0.4
37,37,,3,3,3,6,5,5,10,12,0.193652,0.200503,0.000638,0.000003,0.000003,0.333333
69,69,,3,3,3,6,5,3,8,12,0.193548,0.200214,0,0.000003,0.000003,1
128,128,,3,3,2,5,3,2,5,13,0.162226,0.166346,0.000671,0,0,0
183,183,,3,3,3,6,3,4,7,12,0.193548,0.200214,0,0.000003,0.000003,1
68,68,,3,2,2,4,2,2,4,13,0.162427,0.167085,0.000004,0,0,0
40,40,,3,2,2,4,4,4,8,12,0.192979,0.199943,0.000333,0.000004,0.000004,0
55,55,,3,8,8,16,15,15,30,11,0.239066,0.252602,0.005292,0.000235,0.000238,0.035714
75,75,,3,2,2,4,3,3,6,13,0.161862,0.166329,0,0,0,0
41,41,,3,4,4,8,4,4,8,12,0.186362,0.19338,0.000021,0.000002,0.000002,0.333333
140,140,,3,3,3,6,4,4,8,12,0.19316,0.200636,0.000218,0.000004,0.000004,0
5487,5487,,3,3,4,7,4,5,9,12,0.18629,0.1932,0.000001,0.000002,0.000002,0.5
42,42,,3,3,3,6,3,3,6,12,0.204942,0.212762,0.003572,0.000016,0.000012,0.333333
54,54,,3,9,9,18,10,10,20,13,0.170891,0.177601,0.002746,0,0,0.055556
97,97,,3,2,2,4,2,2,4,13,0.170406,0.17545,0,0,0,1
176,176,,2,3,3,6,3,3,6,11,0.256922,0.271035,0.004233,0.000755,0.001021,0.5
45,45,,2,4,4,8,4,4,8,10,0.275303,0.290799,0.001835,0.001381,0.001375,0.416667
77,77,,2,2,1,3,2,1,3,11,0.215889,0.223202,0,0.000076,0.000022,1
188,188,,3,8,8,16,10,10,20,11,0.220524,0.230962,0.003788,0.000089,0.000089,0.071429
48,48,,2,2,2,4,2,2,4,11,0.255218,0.26831,0.000027,0.000558,0.00056,0
180,180,,2,3,3,6,3,3,6,11,0.238552,0.248858,0.000003,0.000213,0.000213,0.333333
49,49,,2,33,34,67,41,41,82,10,0.313117,0.33775,0.016592,0.012476,0.012487,0.246881
72,72,,3,3,3,6,3,3,6,11,0.239085,0.249897,0,0.000207,0.000207,1
87,87,,2,11,11,22,13,13,26,10,0.284419,0.304956,0.00008,0.004771,0.004789,0.581818
90,90,,2,4,4,8,5,5,10,10,0.276304,0.292156,0.000629,0.001991,0.001984,0.5
99,99,,2,2,2,4,2,2,4,11,0.238493,0.248569,0,0.000204,0.000203,1
100,100,,2,24,23,47,33,32,65,10,0.311394,0.338467,0.010947,0.013919,0.013691,0.338768
120,120,,2,9,9,18,10,10,20,10,0.283358,0.302946,0.000002,0.005271,0.005224,0.666667
122,122,,2,2,2,4,2,2,4,11,0.247896,0.259928,0,0.000665,0.000664,1
136,136,,3,4,4,8,4,4,8,11,0.239105,0.250071,0.000039,0.000208,0.000207,0.5
160,160,,2,23,23,46,30,30,60,10,0.2938,0.317439,0.012515,0.007532,0.007496,0.26087
166,166,,2,8,8,16,9,9,18,10,0.283302,0.302715,0.000001,0.005019,0.004973,0.75
168,168,,2,3,3,6,3,3,6,11,0.238611,0.249031,0.000002,0.000219,0.000219,0.333333
175,175,,2,3,3,6,3,3,6,11,0.251503,0.264402,0,0.000959,0.000958,1
178,178,,2,49,48,97,63,64,127,10,0.328328,0.358194,0.006375,0.028926,0.028941,0.261905
184,184,,2,9,9,18,9,9,18,10,0.289526,0.309046,0.000017,0.004794,0.004813,0.777778
1780,1780,,2,37,38,75,49,50,99,10,0.320952,0.350684,0.002223,0.029056,0.032849,0.396761
1826,1826,,2,14,14,28,14,14,28,10,0.291309,0.31177,0.000317,0.006797,0.006824,0.505495
1836,1836,,2,31,31,62,41,41,82,10,0.308366,0.332903,0.000921,0.0183,0.018317,0.410753
1840,1840,,2,27,27,54,38,38,76,10,0.302041,0.32569,0.000353,0.01568,0.015725,0.512821
1852,1852,,2,75,73,148,113,112,225,9,0.33933,0.376454,0.006781,0.052321,0.051807,0.278559
3462,3462,,2,89,89,178,149,149,298,10,0.326581,0.361114,0.008718,0.039088,0.039199,0.287794
3484,3484,,2,117,117,234,214,211,425,9,0.373786,0.415924,0.04896,0.073862,0.073324,0.217514
3550,3550,,2,90,88,178,107,107,214,9,0.352037,0.390653,0.009917,0.051157,0.05066,0.262672
3839,3839,,2,12,12,24,13,13,26,10,0.291045,0.311233,0.000081,0.008061,0.008074,0.590909
3877,3877,,2,139,138,277,183,183,366,10,0.334609,0.377811,0.02473,0.047489,0.046533,0.127255
3878,3878,,2,111,112,223,177,177,354,10,0.338058,0.379671,0.010792,0.048068,0.048231,0.186535
7266,7266,,2,2,2,4,2,2,4,11,0.238493,0.248569,0,0.000204,0.000203,1
50,50,,3,3,3,6,5,4,9,12,0.186254,0.193021,0,0.000004,0.000004,1
187,187,,3,6,6,12,6,6,12,11,0.22789,0.239139,0.000656,0.000127,0.000127,0.466667
5534,5534,,3,4,4,8,5,5,10,12,0.186266,0.193195,0,0.000004,0.000004,0.666667
139,139,,3,1,1,2,1,1,2,14,0.145957,0.149658,0,0,0,0
145,145,,3,1,1,2,1,1,2,14,0.145957,0.149658,0,0,0,0
155,155,,3,6,5,11,8,7,15,12,0.193769,0.201282,0.002123,0.000003,0.000003,0.266667
206,206,,3,1,1,2,1,1,2,14,0.145957,0.149658,0,0,0,0
4239,4239,,3,3,3,6,3,3,6,13,0.162418,0.167212,0.000001,0,0,0.666667
4244,4244,,3,1,1,2,1,1,2,14,0.145957,0.149658,0,0,0,0
148,148,,3,2,3,5,4,5,9,12,0.193121,0.200509,0.000355,0.000004,0.000004,0.333333
154,154,,3,9,8,17,9,8,17,10,0.254722,0.270199,0.005912,0.000791,0.000797,0.083333
170,170,,3,2,2,4,4,4,8,12,0.192979,0.199943,0.000669,0.000004,0.000004,0
5495,5495,,3,3,4,7,5,6,11,12,0.193082,0.200578,0.00034,0.000004,0.000004,0.166667
58,58,,2,2,2,4,4,4,8,11,0.227119,0.237314,0,0.000122,0.000123,1
5524,5524,,2,2,2,4,4,4,8,11,0.227119,0.237314,0,0.000122,0.000123,1
60,60,,3,1,1,2,2,2,4,12,0.193496,0.199781,0,0.000003,0.000003,0
62,62,,3,4,4,8,4,4,8,10,0.25396,0.268414,0.002285,0.000797,0.000803,0.3
5496,5496,,3,5,5,10,5,5,10,10,0.253871,0.268385,0.001993,0.000797,0.000803,0.25
5516,5516,,3,3,2,5,3,2,5,12,0.168614,0.173243,0.000169,0.000013,0,0.166667
6727,6727,,3,5,5,10,5,5,10,11,0.203325,0.211897,0.002267,0.000026,0.000026,0.1
65,65,,3,2,2,4,2,2,4,10,0.23053,0.24067,0,0.000115,0.000116,1
6775,6775,,3,2,2,4,2,2,4,10,0.23053,0.24067,0,0.000115,0.000116,1
67,67,,4,3,4,7,3,4,7,11,0.218421,0.227747,0.000006,0.000005,0.00004,0.333333
115,115,,4,3,3,6,3,3,6,11,0.227387,0.237967,0.000168,0.000122,0.000122,0
169,169,,4,17,16,33,19,18,37,11,0.218669,0.229999,0.007098,0.000038,0.000038,0.102941
5527,5527,,4,7,7,14,8,8,16,11,0.227782,0.239612,0.003214,0.000122,0.000122,0.267857
70,70,,2,4,4,8,4,4,8,10,0.26747,0.284551,0,0.002737,0.00272,0.5
1760,1760,,2,39,41,80,51,53,104,9,0.332412,0.365203,0.004817,0.040178,0.041537,0.368922
153,153,,3,4,4,8,4,4,8,10,0.253826,0.268195,0.001921,0.000786,0.000792,0
7254,7254,,3,2,2,4,2,2,4,11,0.187561,0.193404,0.000334,0.000002,0.000002,0.5
73,73,,2,22,22,44,35,35,70,10,0.301757,0.327551,0.000573,0.012271,0.012297,0.318182
1441,1441,,2,3,3,6,3,3,6,10,0.253938,0.268154,0,0.001034,0.00104,1
1761,1761,,2,13,13,26,15,15,30,10,0.306825,0.330537,0.000045,0.020251,0.018278,0.67033
1910,1910,,2,10,11,21,16,15,31,10,0.301221,0.325043,0.000459,0.013894,0.012578,0.483516
1918,1918,,2,5,4,9,7,6,13,10,0.279272,0.295725,0,0.002754,0.002696,0.85
1923,1923,,2,13,13,26,17,17,34,9,0.309524,0.336605,0.000099,0.019351,0.019776,0.614286
3533,3533,,2,97,96,193,140,139,279,10,0.324306,0.362334,0.007297,0.03842,0.038443,0.205219
3617,3617,,2,26,26,52,26,26,52,11,0.244556,0.261283,0.000544,0.001203,0.001211,0.009231
3646,3646,,2,63,63,126,82,83,165,10,0.316032,0.347816,0.000858,0.031386,0.031403,0.356119
4069,4069,,2,10,10,20,12,12,24,10,0.299036,0.321701,0.000007,0.011496,0.011532,0.544444
5810,5810,,2,5,5,10,6,6,12,9,0.298665,0.319851,0.000002,0.006942,0.006949,0.85
5852,5852,,2,4,5,9,6,7,13,10,0.279299,0.295898,0.000008,0.002759,0.00274,0.633333
78,78,,2,3,3,6,3,3,6,11,0.247322,0.259344,0.000001,0.000557,0.000556,0.666667
172,172,,2,6,7,13,6,7,13,11,0.257886,0.271999,0.000042,0.000947,0.000958,0.333333
79,79,,2,2,2,4,2,2,4,11,0.248237,0.260299,0,0.000684,0.000688,1
80,80,,3,4,4,8,4,4,8,10,0.231956,0.243115,0.00003,0.000154,0.000154,0.333333
161,161,,3,6,6,12,8,8,16,10,0.254161,0.269067,0.001144,0.000805,0.000811,0.266667
85,85,,2,1,1,2,1,1,2,11,0.247195,0.258767,0,0.000464,0.000464,0
109,109,,3,2,2,4,2,2,4,11,0.217025,0.224889,0,0.000035,0.000035,0
91,91,,4,2,2,4,2,2,4,13,0.16208,0.166411,0.002671,0,0,0
143,143,,4,3,3,6,3,3,6,12,0.193315,0.200265,0.004006,0.000005,0.000005,0
5490,5490,,4,2,2,4,2,2,4,14,0.139521,0.142585,0.002004,0,0,0
94,94,,3,2,2,4,2,2,4,11,0.202797,0.210439,0,0.000015,0.000015,1
5503,5503,,3,4,4,8,4,4,8,11,0.202868,0.21093,0.001925,0.000015,0.000015,0.166667
98,98,,2,1,1,2,1,1,2,11,0.247195,0.258767,0,0.000464,0.000464,0
117,117,,2,4,4,8,4,4,8,10,0.278598,0.296322,0,0.00315,0.003154,1
144,144,,2,9,9,18,9,9,18,10,0.280985,0.299563,0.000941,0.004006,0.004024,0.222222
177,177,,4,2,2,4,2,2,4,11,0.238021,0.249538,0,0.000225,0.000229,1
105,105,,4,2,2,4,2,2,4,12,0.179489,0.185349,0,0.000001,0.000001,0.666667
5464,5464,,4,4,3,7,4,3,7,12,0.179511,0.18558,0.000087,0.000001,0.000001,0.4
108,108,,2,1,2,3,1,2,3,11,0.255172,0.268194,0,0.000555,0.000566,1
173,173,,2,4,3,7,5,3,8,11,0.25524,0.268483,0,0.000588,0.000581,0.583333
5479,5479,,4,2,2,4,2,2,4,11,0.218075,0.226418,0.000001,0.000037,0.000037,0
5480,5480,,4,5,5,10,5,5,10,12,0.179522,0.185868,0.000986,0.000036,0.000001,0.433333
5491,5491,,4,2,2,4,2,2,4,11,0.218058,0.226361,0.000498,0.000035,0.000035,0
5533,5533,,4,3,3,6,3,3,6,12,0.179511,0.18558,0.000333,0.000035,0.000001,0.35
127,127,,2,2,2,4,2,2,4,11,0.255172,0.268194,0,0.000564,0.000566,1
162,162,,2,2,2,4,3,3,6,11,0.255172,0.268194,0,0.000564,0.000566,1
5498,5498,,3,1,1,2,1,1,2,14,0.139589,0.142161,0,0,0,0
130,130,,3,1,2,3,1,2,3,11,0.187561,0.193404,0,0,0.000002,1
5535,5535,,3,4,4,8,4,4,8,12,0.169585,0.17532,0.000833,0,0,0
141,141,,3,3,3,6,3,3,6,11,0.227173,0.237603,0,0.000124,0.000125,1
5497,5497,,3,3,3,6,3,3,6,11,0.227173,0.237603,0,0.000124,0.000125,1
190,190,,4,1,1,2,1,1,2,13,0.162007,0.166019,0,0,0,0
3515,3515,,2,9,9,18,9,9,18,10,0.281287,0.300722,0.000011,0.00631,0.006313,0.722222
3747,3747,,2,59,59,118,64,64,128,10,0.305461,0.333887,0.000485,0.023356,0.023384,0.348627
210,210,,5,59,60,119,77,78,155,9,0.327508,0.364152,0.012356,0.047606,0.04789,0.228531
302,302,,5,112,114,226,141,143,284,9,0.351565,0.398731,0.00686,0.11485,0.112509,0.238165
346,346,,5,148,149,297,229,230,459,9,0.372483,0.420723,0.013292,0.142695,0.142946,0.215627
1074,1074,,5,84,84,168,113,117,230,9,0.33341,0.371359,0.006244,0.066599,0.066986,0.201961
1218,1218,,5,143,141,284,224,224,448,9,0.360795,0.408365,0.010731,0.136268,0.135374,0.238156
1230,1230,,5,97,97,194,153,155,308,9,0.318122,0.359185,0.003275,0.087205,0.087278,0.244953
1354,1354,,5,77,77,154,95,95,190,9,0.334415,0.372202,0.003814,0.082407,0.083047,0.316017
1555,1555,,5,153,154,307,253,249,502,9,0.37632,0.425447,0.01755,0.144024,0.145547,0.203885
1665,1665,,5,72,73,145,87,89,176,9,0.338137,0.377219,0.001575,0.088721,0.08913,0.374239
1678,1678,,5,122,123,245,163,162,325,9,0.369054,0.413793,0.007896,0.13212,0.13317,0.283753
1800,1800,,2,11,12,23,12,12,24,10,0.29383,0.315239,0.000005,0.011117,0.011777,0.863636
1824,1824,,2,81,80,161,160,158,318,9,0.336913,0.374021,0.021309,0.042787,0.041725,0.18179
1897,1897,,2,14,13,27,20,19,39,9,0.297128,0.318756,0.000438,0.005654,0.006573,0.352381
1902,1902,,2,1,2,3,1,2,3,10,0.277847,0.293502,0,0.000783,0.002109,1
1903,1903,,2,2,2,4,2,2,4,10,0.258718,0.273583,0,0.001188,0.00118,1
1909,1909,,2,33,36,69,44,47,91,9,0.321847,0.353545,0.00493,0.02431,0.025186,0.203414
1953,1953,,2,37,37,74,53,52,105,10,0.30472,0.331386,0.008707,0.018246,0.018259,0.212462
2170,2170,,5,60,61,121,92,93,185,9,0.339809,0.376244,0.002582,0.065888,0.067208,0.419672
2875,2875,,2,20,21,41,27,27,54,10,0.310857,0.336612,0.0014,0.014774,0.015096,0.338095
2878,2878,,2,8,8,16,16,15,31,9,0.271521,0.290771,0.000118,0.002872,0.00262,0.375
2881,2881,,2,11,11,22,20,19,39,9,0.268665,0.288542,0.000733,0.002594,0.002619,0.272727
3576,3576,,2,102,104,206,160,164,324,9,0.35208,0.395106,0.021826,0.066393,0.066625,0.214652
3645,3645,,2,89,86,175,115,113,228,9,0.346667,0.383094,0.008593,0.050332,0.049788,0.282942
3670,3670,,2,106,106,212,131,132,263,9,0.349861,0.389533,0.007246,0.056966,0.056881,0.256783
3697,3697,,2,43,43,86,55,57,112,10,0.295122,0.322764,0.000379,0.020307,0.020394,0.42389
3751,3751,,2,114,113,227,200,198,398,10,0.32949,0.36865,0.022281,0.042353,0.042366,0.179941
3793,3793,,2,40,40,80,55,55,110,10,0.302199,0.330138,0.000373,0.022139,0.022166,0.378846
3941,3941,,5,98,98,196,140,140,280,9,0.341336,0.381043,0.015687,0.089956,0.090078,0.235851
5514,5514,,3,2,2,4,2,2,4,10,0.253603,0.267485,0.000666,0.000784,0.00079,0
149,149,,3,1,1,2,1,1,2,11,0.202455,0.209509,0,0.000013,0.000013,0
152,152,,3,1,1,2,2,2,4,13,0.161771,0.165833,0,0,0,0
5507,5507,,3,4,4,8,4,4,8,11,0.202711,0.210607,0.000505,0.000013,0.000013,0
5481,5481,,3,3,3,6,3,3,6,11,0.203111,0.211013,0.001034,0.000013,0.000013,0.166667
5512,5512,,3,2,2,4,2,2,4,11,0.203282,0.211065,0.000066,0.000013,0.000013,0
5520,5520,,3,3,3,6,3,3,6,11,0.203225,0.211319,0.000008,0.000013,0.000013,0.333333
6728,6728,,3,2,2,4,2,2,4,11,0.203054,0.210696,0.000167,0.000013,0.000013,0.5
4238,4238,,3,2,2,4,2,2,4,13,0.162345,0.166664,0.000001,0,0,0.5
5462,5462,,3,2,2,4,2,2,4,13,0.162335,0.166606,0,0,0,1
164,164,,2,1,1,2,1,1,2,11,0.25515,0.268021,0,0.000555,0.000557,0
179,179,,2,3,2,5,3,3,6,11,0.255172,0.268194,0,0.000579,0.000566,1
200,200,,2,2,2,4,2,2,4,11,0.255195,0.268252,0.000669,0.000555,0.000557,0
2006,2006,,30,38,37,75,60,59,119,9,0.322638,0.349889,0.011477,0.014977,0.014402,0.273115
2276,2276,,30,76,77,153,167,168,335,9,0.349395,0.384283,0.01902,0.03536,0.036957,0.305366
3364,3364,,30,170,170,340,329,328,657,9,0.3683,0.419794,0.042993,0.082251,0.082225,0.127149
3406,3406,,30,126,126,252,255,255,510,9,0.354633,0.4008,0.021146,0.0618,0.061864,0.172952
3456,3456,,2,23,22,45,36,35,71,10,0.286395,0.307912,0.00173,0.010186,0.008862,0.519763
3469,3469,,2,65,64,129,123,123,246,9,0.350285,0.385894,0.005091,0.054145,0.053596,0.434375
3514,3514,,2,10,11,21,18,18,36,10,0.287136,0.305824,0.000009,0.005438,0.006809,0.863636
3602,3602,,2,10,10,20,14,15,29,10,0.282415,0.300341,0.000009,0.005438,0.005479,0.866667
3728,3728,,2,45,45,90,78,78,156,10,0.322747,0.352134,0.013648,0.018739,0.018733,0.269697
3731,3731,,2,41,41,82,50,50,100,10,0.306956,0.33386,0.000146,0.024576,0.024641,0.562195
3830,3830,,2,112,113,225,187,188,375,9,0.366104,0.407961,0.02501,0.082888,0.083081,0.248176
3930,3930,,30,117,119,236,240,242,482,9,0.36629,0.410652,0.026156,0.065381,0.067724,0.183471
5523,5523,,2,1,1,2,1,1,2,11,0.25515,0.268021,0,0.000555,0.000557,0
5545,5545,,2,1,1,2,1,1,2,11,0.25515,0.268021,0,0.000555,0.000557,0
6738,6738,,2,1,2,3,1,2,3,11,0.255195,0.268252,0.000334,0.000555,0.000557,0.5
174,174,,2,3,3,6,3,3,6,11,0.25986,0.275895,0,0.001359,0.001357,1
5550,5550,,3,2,2,4,2,2,4,11,0.202868,0.210618,0,0.000014,0.000014,1
5465,5465,,4,3,3,6,3,3,6,12,0.179478,0.185435,0,0.000001,0.000001,1
5468,5468,,4,3,3,6,3,3,6,12,0.179478,0.185435,0.000277,0.000001,0.000001,0.333333
5469,5469,,4,2,2,4,2,2,4,12,0.179466,0.185262,0.000085,0.000001,0.000001,0
5478,5478,,4,2,2,4,2,2,4,12,0.179466,0.185262,0,0.000001,0.000001,1
5489,5489,,4,2,2,4,2,2,4,12,0.179455,0.185204,0,0.000001,0.000001,1
5521,5521,,4,4,5,9,4,5,9,12,0.18635,0.193753,0.000364,0.000003,0.000003,0.5
5531,5531,,4,5,6,11,5,6,11,11,0.218438,0.228035,0.000814,0.000001,0.000036,0.433333
5546,5546,,4,2,2,4,2,2,4,12,0.179466,0.185262,0.000196,0.000001,0.000001,0
5547,5547,,4,3,3,6,3,3,6,12,0.179478,0.185435,0.000196,0.000001,0.000001,0.333333
5548,5548,,4,4,4,8,4,4,8,12,0.186338,0.19358,0.000168,0.000003,0.000003,0.75
1856,1856,,2,6,6,12,8,8,16,10,0.283999,0.301494,0.000004,0.003802,0.003833,0.666667
182,182,,2,1,1,2,1,1,2,10,0.274596,0.289361,0,0.001325,0.001319,0
5461,5461,,3,2,2,4,4,4,8,12,0.180725,0.186394,0.000334,0.000001,0.000001,0
5488,5488,,3,2,2,4,3,3,6,12,0.181168,0.187025,0.000006,0.000002,0.000002,0
7252,7252,,3,3,3,6,5,5,10,12,0.180736,0.186567,0.001002,0.000001,0.000001,0.333333
469,469,,5,79,78,157,114,115,229,9,0.325734,0.36303,0.003169,0.064169,0.063398,0.161798
534,534,,5,39,40,79,59,54,113,9,0.320204,0.350896,0.000681,0.04012,0.040476,0.352439
599,599,,5,130,130,260,162,162,324,9,0.333564,0.379534,0.008089,0.116462,0.115489,0.238814
1590,1590,,7,67,69,136,118,123,241,9,0.355506,0.392796,0.00355,0.08233,0.082859,0.394075
1613,1613,,5,109,110,219,175,181,356,9,0.351009,0.394678,0.0046,0.113006,0.11223,0.271097
1633,1633,,26,16,16,32,17,18,35,10,0.302167,0.327678,0.003049,0.013473,0.013208,0.264706
1636,1636,,5,52,52,104,59,59,118,9,0.31541,0.349477,0.001925,0.050536,0.050726,0.307692
1638,1638,,5,80,82,162,117,120,237,9,0.334376,0.376056,0.011109,0.081713,0.083712,0.286659
1701,1701,,5,169,169,338,241,240,481,9,0.372531,0.424108,0.028216,0.128503,0.128515,0.15522
1754,1754,,2,19,20,39,23,24,47,10,0.295485,0.317326,0.002806,0.011543,0.011759,0.315789
1759,1759,,5,1,3,4,1,3,4,10,0.285375,0.304779,0,0.001325,0.005047,1
1779,1779,,2,15,15,30,18,19,37,10,0.297495,0.321407,0.000056,0.009677,0.009702,0.466667
1885,1885,,2,38,38,76,45,45,90,10,0.312846,0.341589,0.00675,0.020776,0.02076,0.312821
1892,1892,,2,24,25,49,33,33,66,10,0.31079,0.33646,0.000225,0.017701,0.019962,0.618333
1904,1904,,2,2,3,5,3,4,7,10,0.279083,0.29535,0,0.00173,0.002499,1
1926,1926,,2,19,19,38,23,23,46,10,0.296,0.318375,0.002849,0.014639,0.01455,0.488304
1941,1941,,2,3,3,6,4,4,8,10,0.275355,0.290978,0.000054,0.001623,0.001617,0.666667
1948,1948,,2,6,6,12,7,7,14,10,0.282415,0.302295,0.000001,0.004592,0.004579,0.866667
2179,2179,,30,73,75,148,120,118,238,9,0.353807,0.394355,0.006396,0.062921,0.062938,0.298018
2188,2188,,30,165,166,331,291,294,585,9,0.387019,0.437627,0.053219,0.111195,0.111456,0.148229
2206,2206,,30,39,38,77,58,58,116,9,0.320027,0.350574,0.003683,0.021124,0.023304,0.321795
2207,2207,,30,33,32,65,46,43,89,9,0.321596,0.351262,0.002684,0.029492,0.026375,0.387395
2223,2223,,30,34,35,69,45,46,91,9,0.325037,0.356517,0.003652,0.028296,0.030678,0.319069
2564,2564,,34,81,83,164,145,145,290,9,0.345257,0.384918,0.050748,0.052309,0.05242,0.18851
2650,2650,,2,36,35,71,56,55,111,9,0.323869,0.352596,0.01323,0.017,0.016906,0.238095
2709,2709,,2,67,67,134,106,105,211,9,0.324561,0.360194,0.027229,0.026922,0.02684,0.127318
2789,2789,,2,35,35,70,48,53,101,10,0.320382,0.349096,0.012458,0.019196,0.019169,0.229412
2851,2851,,2,41,41,82,74,74,148,9,0.323289,0.354765,0.006441,0.026785,0.026543,0.251829
2874,2874,,2,23,23,46,28,27,55,10,0.299688,0.324415,0.001878,0.014424,0.012152,0.315217
2894,2894,,2,9,10,19,11,12,23,10,0.30725,0.330941,0.000006,0.009619,0.013093,0.654545
2895,2895,,2,27,27,54,40,40,80,10,0.308169,0.335371,0.001147,0.019876,0.019228,0.43254
2899,2899,,2,32,32,64,39,42,81,9,0.306532,0.332535,0.00295,0.021183,0.017661,0.294118
2902,2902,,2,20,20,40,26,26,52,10,0.29413,0.315626,0.00036,0.009261,0.009376,0.323684
2939,2939,,7,75,76,151,103,104,207,9,0.343245,0.382481,0.004743,0.081628,0.082447,0.35386
3093,3093,,30,92,92,184,221,221,442,9,0.348467,0.389712,0.018579,0.063732,0.063611,0.202197
3488,3488,,2,48,48,96,52,52,104,9,0.317946,0.346399,0.001153,0.029978,0.030029,0.472048
3520,3520,,2,34,34,68,47,47,94,10,0.302611,0.328398,0.000138,0.020751,0.020865,0.619048
3720,3720,,2,38,38,76,51,50,101,10,0.322134,0.349402,0.004496,0.023931,0.023932,0.472262
3722,3722,,2,20,20,40,28,28,56,10,0.293651,0.31562,0.000302,0.014517,0.014531,0.565789
3752,3752,,2,67,67,134,100,100,200,9,0.333372,0.368552,0.001466,0.056482,0.056419,0.390694
3861,3861,,2,32,32,64,39,39,78,10,0.306077,0.331165,0.000156,0.023951,0.023964,0.732863
3876,3876,,2,81,81,162,95,95,190,9,0.334144,0.371105,0.002522,0.047903,0.047908,0.314198
4029,4029,,7,158,159,317,240,241,481,9,0.349861,0.398247,0.03963,0.073587,0.073707,0.066476
4067,4067,,2,8,8,16,10,10,20,10,0.289381,0.308881,0.000004,0.006704,0.006728,0.553571
4237,4237,,3,2,3,5,2,3,5,12,0.193652,0.200532,0.000333,0.000003,0.000003,0.666667
5463,5463,,3,1,1,2,1,1,2,12,0.193496,0.199781,0,0.000003,0.000003,0
5511,5511,,3,1,1,2,1,1,2,12,0.193496,0.199781,0,0.000003,0.000003,0
5526,5526,,3,1,1,2,1,1,2,12,0.193496,0.199781,0,0.000003,0.000003,0
7275,7275,,2,1,1,2,1,1,2,12,0.203325,0.209826,0,0.000009,0.000009,0
7255,7255,,3,1,1,2,1,1,2,11,0.202725,0.210093,0,0.000015,0.000015,0
209,209,,5,5,5,10,7,7,14,10,0.260469,0.279563,0,0.003656,0.003628,1
231,231,,5,18,18,36,24,25,49,10,0.297556,0.324426,0.000172,0.015546,0.015502,0.513072
1335,1335,,5,59,59,118,84,81,165,9,0.31617,0.350981,0.00156,0.056077,0.056778,0.301412
1353,1353,,5,59,59,118,77,75,152,9,0.310356,0.344596,0.001641,0.045313,0.045318,0.234746
1386,1386,,5,112,115,227,153,158,311,9,0.332718,0.375101,0.015149,0.061552,0.062316,0.079207
211,211,,5,2,2,4,2,2,4,10,0.246751,0.261141,0,0.000781,0.000777,1
216,216,,5,2,2,4,2,2,4,10,0.246751,0.261141,0,0.000781,0.000777,1
220,220,,5,6,6,12,8,8,16,10,0.286423,0.307586,0,0.006321,0.006265,0.933333
221,221,,5,8,8,16,12,12,24,10,0.28685,0.30851,0.000011,0.007712,0.007653,0.785714
227,227,,5,1,1,2,1,1,2,10,0.24673,0.260968,0,0.000769,0.000764,0
230,230,,5,3,3,6,5,5,10,10,0.259743,0.278033,0,0.002496,0.002479,1
234,234,,6,2,2,4,2,2,4,10,0.246857,0.261401,0,0.000782,0.000778,1
235,235,,5,4,4,8,5,5,10,10,0.260094,0.278708,0,0.002929,0.002901,1
237,237,,6,3,3,6,3,3,6,10,0.246899,0.261632,0.000669,0.000769,0.000778,0.25
238,238,,6,3,3,6,3,3,6,10,0.284559,0.303688,0.000239,0.003447,0.003415,0.666667
242,242,,5,1,1,2,1,1,2,10,0.24673,0.260968,0,0.000769,0.000764,0
243,243,,6,2,2,4,2,2,4,10,0.246772,0.261199,0.000334,0.000769,0.000764,0
244,244,,6,7,7,14,7,7,14,10,0.246983,0.262325,0.003007,0.000849,0.000833,0.125
246,246,,5,14,13,27,19,19,38,10,0.288081,0.310329,0.000473,0.00936,0.008326,0.549451
280,280,,5,6,6,12,9,8,17,10,0.285771,0.3062,0,0.005515,0.005508,1
287,287,,5,52,54,106,67,68,135,9,0.325073,0.360956,0.001999,0.061523,0.061756,0.402516
344,344,,5,82,82,164,108,107,215,10,0.308861,0.349608,0.001198,0.075576,0.07585,0.253086
1044,1044,,5,19,17,36,30,27,57,10,0.292135,0.317444,0.001946,0.011357,0.010282,0.377193
1084,1084,,5,23,24,47,33,34,67,10,0.317317,0.345572,0.000471,0.02227,0.022378,0.387681
1094,1094,,5,6,5,11,6,5,11,10,0.286594,0.306691,0.000001,0.00594,0.005815,0.866667
1128,1128,,5,82,83,165,126,126,252,9,0.34041,0.382154,0.006369,0.074841,0.075028,0.279606
1157,1157,,5,51,51,102,65,65,130,9,0.325,0.360535,0.005466,0.043967,0.044119,0.256078
1229,1229,,5,156,155,311,270,271,541,9,0.370095,0.42241,0.027673,0.139729,0.13799,0.197681
1246,1246,,5,52,52,104,57,57,114,10,0.306728,0.341557,0.000231,0.057247,0.057303,0.450226
1264,1264,,5,24,24,48,27,27,54,10,0.300719,0.328393,0.000304,0.027243,0.027144,0.478333
1273,1273,,5,33,33,66,40,41,81,9,0.308729,0.340081,0.000638,0.043377,0.04425,0.529412
1320,1320,,5,3,3,6,3,3,6,10,0.250717,0.266992,0,0.002206,0.002187,0.833333
1399,1399,,5,10,9,19,11,10,21,10,0.265942,0.286901,0.000033,0.007597,0.007116,0.511111
1423,1423,,5,8,7,15,9,8,17,10,0.260094,0.279159,0.000001,0.004083,0.003604,0.589286
1524,1524,,5,113,109,222,168,164,332,9,0.35994,0.403681,0.00587,0.124862,0.119957,0.282848
2072,2072,,30,87,98,185,146,156,302,9,0.334647,0.375386,0.01641,0.045094,0.0462,0.14832
2074,2074,,30,34,21,55,46,29,75,10,0.287565,0.311385,0.000443,0.015326,0.010689,0.331551
2177,2177,,5,46,47,93,70,75,145,9,0.317527,0.350759,0.000415,0.048462,0.046917,0.430697
2236,2236,,5,49,50,99,81,82,163,9,0.323361,0.358036,0.002729,0.04587,0.050701,0.380392
2241,2241,,30,92,91,183,124,125,249,9,0.363247,0.406696,0.011261,0.081247,0.081254,0.28452
2985,2985,,7,118,117,235,171,170,341,9,0.35612,0.401909,0.016318,0.099143,0.099013,0.199406
3998,3998,,5,99,99,198,189,190,379,9,0.311562,0.352954,0.001795,0.081783,0.080845,0.208889
5552,5552,,5,5,5,10,5,6,11,10,0.260469,0.279563,0,0.003656,0.003628,1
5553,5553,,5,1,1,2,1,1,2,10,0.24673,0.260968,0,0.000769,0.000764,0
6492,6492,,5,5,5,10,7,7,14,10,0.260469,0.279563,0,0.003465,0.003444,0.9
214,214,,6,2,2,4,2,2,4,11,0.198051,0.205666,0,0.000025,0.000025,0
222,222,,6,1,1,2,1,1,2,11,0.198078,0.205666,0,0.000013,0.000014,0
236,236,,6,1,1,2,1,1,2,11,0.198037,0.205493,0,0.000013,0.000012,0.5
239,239,,6,1,1,2,1,1,2,11,0.198078,0.205666,0,0.000013,0.000014,0
240,240,,6,2,1,3,2,1,3,12,0.165358,0.169862,0.000334,0.000014,0,0.5
5555,5555,,6,1,2,3,1,2,3,11,0.198105,0.205897,0.000334,0,0.000014,0.5
245,245,,5,13,13,26,28,31,59,10,0.287565,0.309862,0.000017,0.006159,0.006557,0.56044
253,253,,5,12,13,25,17,19,36,10,0.285827,0.307222,0.000392,0.004682,0.005927,0.505495
273,273,,5,33,31,64,47,45,92,9,0.32056,0.351156,0.004787,0.028571,0.026087,0.290553
883,883,,5,12,9,21,19,16,35,10,0.288485,0.309269,0.000036,0.006184,0.005042,0.560606
886,886,,5,8,8,16,16,16,32,10,0.289062,0.309933,0.000006,0.005341,0.005363,0.767857
897,897,,5,18,17,35,30,29,59,10,0.290693,0.31503,0.001043,0.010621,0.010536,0.374269
970,970,,5,13,14,27,21,20,41,10,0.290781,0.313716,0.001362,0.006316,0.00678,0.395604
4059,4059,,5,63,63,126,100,94,194,9,0.320417,0.356271,0.016183,0.029002,0.028976,0.129939
247,247,,5,2,2,4,2,2,4,11,0.223981,0.234287,0,0.000229,0.000225,1
248,248,,5,27,28,55,38,38,76,9,0.321274,0.349714,0.003038,0.023618,0.026596,0.305376
298,298,,5,10,10,20,11,11,22,10,0.286907,0.308245,0.000016,0.007652,0.005886,0.654545
249,249,,5,1,1,2,1,1,2,10,0.243175,0.254681,0,0.000427,0.000379,0
251,251,,5,1,0,1,1,0,1,0,0,0,0,0.000427,0,0
252,252,,5,1,1,2,1,1,2,10,0.243175,0.254681,0,0.000427,0.000379,0
270,270,,5,7,7,14,14,13,27,10,0.287737,0.30923,0.000065,0.003707,0.006007,0.5
345,345,,5,121,120,241,179,176,355,9,0.352467,0.398698,0.005034,0.117696,0.117018,0.236689
813,813,,5,70,69,139,108,102,210,9,0.343163,0.382204,0.019345,0.043626,0.041657,0.167495
1050,1050,,5,9,10,19,15,14,29,10,0.280712,0.303527,0.000271,0.007021,0.008706,0.366667
1059,1059,,5,8,10,18,12,15,27,10,0.285629,0.305092,0.000167,0.002269,0.004735,0.522222
1063,1063,,5,5,4,9,8,7,15,10,0.25367,0.269222,0.000002,0.003464,0.001559,0.65
1107,1107,,5,55,54,109,71,69,140,9,0.319531,0.354178,0.012214,0.030384,0.029184,0.181791
3682,3682,,2,167,168,335,233,234,467,9,0.364762,0.415197,0.034169,0.087026,0.087165,0.140255
3714,3714,,2,68,71,139,90,93,183,9,0.361518,0.399806,0.006823,0.065492,0.066431,0.342656
5556,5556,,5,1,1,2,1,1,2,10,0.243175,0.254681,0,0.000427,0.000379,0
1062,1062,,5,6,6,12,8,8,16,10,0.231324,0.244039,0.000669,0.000557,0.000481,0.5
4162,4162,,5,10,12,22,17,19,36,10,0.285037,0.305663,0.000304,0.004636,0.005037,0.431818
260,260,,5,16,16,32,25,25,50,10,0.302738,0.326036,0.002587,0.012054,0.00967,0.216374
261,261,,5,2,0,2,2,0,2,0,0,0,0,0.000574,0,1
262,262,,5,2,2,4,3,3,6,10,0.242848,0.255526,0,0.000574,0.000652,1
263,263,,5,2,2,4,2,2,4,10,0.242848,0.255526,0,0.000574,0.000652,1
267,267,,5,1,1,2,1,1,2,11,0.232405,0.242402,0,0.000155,0.000193,0
275,275,,5,2,2,4,4,6,10,10,0.242848,0.255526,0,0.000574,0.000652,1
276,276,,5,1,1,2,2,2,4,11,0.232405,0.242402,0,0.000155,0.000193,0
6730,6730,,5,2,1,3,3,2,5,10,0.242766,0.255179,0,0.000574,0.000459,1
6972,6972,,5,1,2,3,1,2,3,10,0.242848,0.255526,0,0.000155,0.000652,1
264,264,,5,2,2,4,4,4,8,10,0.243524,0.256305,0,0.000515,0.000518,1
268,268,,5,1,1,2,1,1,2,10,0.242766,0.255179,0,0.000419,0.000459,0
269,269,,5,1,2,3,1,2,3,10,0.242848,0.255526,0,0.000419,0.000652,1
286,286,,5,20,19,39,30,29,59,10,0.288369,0.315299,0.000022,0.02116,0.020949,0.360526
490,490,,5,73,73,146,95,97,192,10,0.304559,0.340825,0.000982,0.057346,0.057222,0.210046
492,492,,5,75,75,150,92,92,184,10,0.30363,0.340548,0.001859,0.058118,0.058063,0.166126
521,521,,5,49,50,99,67,70,137,9,0.317562,0.349938,0.000806,0.047436,0.047473,0.306939
523,523,,5,55,56,111,81,81,162,10,0.299222,0.331874,0.000598,0.043705,0.043743,0.193506
1418,1418,,5,23,24,47,29,30,59,10,0.296395,0.324117,0.000351,0.02297,0.02259,0.38
1739,1739,,5,46,44,90,61,59,120,9,0.312169,0.345956,0.000372,0.056275,0.053767,0.430435
5562,5562,,5,18,18,36,24,24,48,10,0.258163,0.28143,0.000006,0.0134,0.013299,0.114379
290,290,,5,1,1,2,1,1,2,11,0.208255,0.21708,0,0.000991,0.000068,1
293,293,,5,19,19,38,25,26,51,9,0.298202,0.324086,0.000057,0.024351,0.024351,0.505848
295,295,,5,5,4,9,5,4,9,10,0.260446,0.280007,0.000004,0.003158,0.003072,0.6
296,296,,5,5,5,10,5,5,10,10,0.262985,0.281634,0.000335,0.004236,0.004248,0.566667
1154,1154,,5,14,13,27,17,16,33,10,0.28745,0.309942,0.000859,0.011544,0.009157,0.472527
1156,1156,,5,4,4,8,5,5,10,10,0.258463,0.27633,0,0.00305,0.003079,1
1435,1435,,5,8,8,16,8,8,16,10,0.288947,0.311409,0.000002,0.009747,0.009978,0.722222
1512,1512,,5,35,35,70,49,49,98,9,0.302801,0.333492,0.001538,0.039283,0.037508,0.377778
1551,1551,,5,51,51,102,68,68,136,9,0.330055,0.363707,0.000324,0.069498,0.069489,0.490196
1606,1606,,5,60,60,120,74,73,147,9,0.319814,0.358267,0.000449,0.076084,0.076227,0.414689
2176,2176,,30,57,57,114,98,100,198,9,0.326102,0.359678,0.002308,0.039537,0.039638,0.323956
5804,5804,,5,3,3,6,3,3,6,10,0.245784,0.260602,0,0.001237,0.001271,0.666667
342,342,,5,81,79,160,112,110,222,9,0.330282,0.369486,0.002156,0.090844,0.090175,0.34598
629,629,,5,45,43,88,47,45,92,9,0.30598,0.337091,0.000363,0.055378,0.05401,0.40628
7447,7447,,5,8,8,16,10,10,20,10,0.29425,0.316538,0,0.013615,0.013635,0.767857
351,351,,5,86,87,173,112,112,224,9,0.34435,0.384918,0.003264,0.094342,0.094551,0.309276
352,352,,5,47,51,98,64,68,132,10,0.307348,0.342443,0.000425,0.054237,0.05756,0.374811
353,353,,5,30,30,60,33,34,67,10,0.296852,0.325079,0.000072,0.031083,0.031099,0.393103
415,415,,5,29,29,58,30,30,60,10,0.305203,0.336039,0.000055,0.036636,0.036691,0.48399
491,491,,5,66,66,132,75,75,150,10,0.302452,0.337401,0.000933,0.048968,0.048808,0.192774
495,495,,5,31,31,62,34,34,68,9,0.300719,0.329861,0.001722,0.026643,0.026593,0.296774
669,669,,5,40,40,80,45,45,90,9,0.307087,0.339331,0.00011,0.04727,0.047225,0.458333
687,687,,5,35,36,71,44,44,88,10,0.307742,0.3394,0.000709,0.04231,0.043303,0.438095
738,738,,5,9,9,18,10,10,20,10,0.267,0.286006,0.000704,0.00412,0.004123,0.166667
951,951,,5,26,28,54,33,34,67,9,0.314276,0.341277,0.007822,0.015931,0.014733,0.165517
1064,1064,,5,24,25,49,29,30,59,9,0.306695,0.336241,0.000189,0.033077,0.036006,0.544974
1066,1066,,5,7,7,14,10,9,19,10,0.288225,0.310081,0.000001,0.008372,0.008352,0.761905
1070,1070,,5,8,8,16,10,10,20,10,0.293114,0.316178,0.000002,0.010418,0.010377,0.696429
1075,1075,,5,27,28,55,45,46,91,9,0.308696,0.337927,0.000294,0.037528,0.037678,0.560345
1080,1080,,5,11,11,22,14,13,27,9,0.300719,0.325068,0.000007,0.017482,0.017498,0.663636
1120,1120,,5,3,2,5,5,5,10,10,0.242725,0.256894,0,0.002306,0.000576,0.666667
1165,1165,,5,11,9,20,15,16,31,10,0.260681,0.279439,0.000695,0.006864,0.002232,0.401515
1190,1190,,5,28,28,56,34,34,68,10,0.290605,0.320271,0.000287,0.02469,0.024858,0.256614
1194,1194,,5,43,43,86,59,59,118,9,0.312812,0.345937,0.000312,0.059813,0.059978,0.509967
1208,1208,,5,30,29,59,36,35,71,9,0.308465,0.337846,0.000205,0.042432,0.042391,0.54023
1216,1216,,5,22,22,44,30,30,60,9,0.306434,0.334458,0.000047,0.037325,0.037391,0.725108
1253,1253,,5,39,39,78,50,50,100,9,0.30163,0.331644,0.000129,0.036907,0.0371,0.448718
1489,1489,,5,77,77,154,103,103,206,9,0.333487,0.374054,0.001777,0.089718,0.089689,0.379016
1509,1509,,5,40,41,81,61,62,123,9,0.304046,0.334751,0.000128,0.048673,0.049634,0.426829
1526,1526,,5,29,29,58,36,36,72,9,0.308169,0.338626,0.000224,0.033147,0.033195,0.366995
1529,1529,,5,25,24,49,38,37,75,9,0.30896,0.3381,0.000232,0.034663,0.034552,0.498333
1538,1538,,5,56,54,110,64,64,128,9,0.313151,0.350089,0.000513,0.056584,0.055318,0.31526
1561,1561,,5,43,43,86,55,55,110,9,0.308004,0.340382,0.000114,0.057428,0.057609,0.502769
1563,1563,,5,13,13,26,14,14,28,10,0.295183,0.319912,0.000008,0.01839,0.018386,0.551282
1569,1569,,5,26,26,52,32,32,64,9,0.309093,0.340076,0.000253,0.037557,0.037641,0.563077
1587,1587,,5,103,104,207,137,139,276,9,0.33937,0.381927,0.002955,0.104919,0.105121,0.28174
1626,1626,,5,57,58,115,94,94,188,9,0.314242,0.349096,0.000655,0.055391,0.056677,0.257411
1657,1657,,5,49,49,98,69,68,137,9,0.320382,0.353716,0.003184,0.060984,0.060982,0.446854
1737,1737,,5,12,12,24,12,12,24,10,0.283358,0.307778,0,0.018409,0.018465,0.795455
1742,1742,,5,21,19,40,22,20,42,10,0.297495,0.324027,0.000018,0.030245,0.028283,0.57619
2997,2997,,30,71,68,139,172,171,343,9,0.331229,0.368822,0.006895,0.048489,0.047226,0.244483
3144,3144,,30,34,35,69,77,75,152,9,0.314276,0.343223,0.001399,0.022862,0.023348,0.436975
3953,3953,,5,77,76,153,89,88,177,9,0.332144,0.3707,0.005415,0.078951,0.078538,0.290376
3959,3959,,5,21,21,42,22,22,44,10,0.302041,0.330583,0.000037,0.030009,0.030033,0.628571
4161,4161,,5,6,5,11,8,8,16,10,0.288139,0.308995,0.000002,0.006315,0.006185,0.833333
4317,4317,,5,56,56,112,70,70,140,9,0.309027,0.34443,0.001733,0.05016,0.05002,0.227597
5673,5673,,5,10,9,19,14,13,27,9,0.299067,0.322885,0.000004,0.017899,0.016597,0.633333
5783,5783,,5,3,3,6,3,3,6,10,0.271828,0.290354,0.000003,0.004037,0.004089,0.333333
6780,6780,,5,2,2,4,2,2,4,10,0.276649,0.295737,0,0.003868,0.003905,1
304,304,,5,67,67,134,67,67,134,10,0.288571,0.322943,0.000605,0.044149,0.044188,0.206468
441,441,,5,4,4,8,4,4,8,10,0.25192,0.27017,0,0.003383,0.003389,0.833333
535,535,,5,75,75,150,86,86,172,9,0.315341,0.352717,0.001851,0.07323,0.073223,0.326306
657,657,,5,36,36,72,38,38,76,10,0.288369,0.318343,0.000203,0.028847,0.028949,0.318254
680,680,,5,24,24,48,24,24,48,10,0.265355,0.290418,0.000015,0.017467,0.017564,0.396739
691,691,,5,18,18,36,18,18,36,10,0.266704,0.290909,0.000006,0.014807,0.014848,0.477124
699,699,,5,50,50,100,50,50,100,10,0.287938,0.32004,0.000267,0.036229,0.03643,0.315102
1051,1051,,5,58,57,115,101,97,198,9,0.305042,0.33869,0.000403,0.057146,0.058198,0.306452
1054,1054,,5,83,84,167,139,145,284,10,0.309225,0.348184,0.001759,0.072097,0.07227,0.245238
1055,1055,,5,59,61,120,111,113,224,10,0.304142,0.337945,0.000333,0.054778,0.056184,0.285817
1056,1056,,5,84,87,171,155,152,307,9,0.313389,0.354582,0.001563,0.075846,0.076052,0.251959
1197,1197,,5,52,53,105,80,81,161,9,0.320809,0.354621,0.000231,0.06648,0.066687,0.444444
1209,1209,,5,10,10,20,10,10,20,10,0.260188,0.281953,0.000005,0.007842,0.007853,0.411111
1222,1222,,5,52,52,104,52,52,104,10,0.295062,0.326363,0.000426,0.033435,0.033581,0.245852
1225,1225,,5,36,36,72,46,44,90,9,0.302738,0.332587,0.000082,0.036241,0.036289,0.436508
1236,1236,,5,30,30,60,31,31,62,10,0.270579,0.298153,0.000029,0.023036,0.023228,0.347126
1247,1247,,5,7,7,14,7,7,14,10,0.269267,0.290785,0,0.008409,0.008414,0.809524
1251,1251,,5,16,16,32,16,16,32,10,0.280439,0.305176,0.000003,0.017647,0.017682,0.7625
1252,1252,,5,15,15,30,17,17,34,10,0.256169,0.279512,0.000002,0.013065,0.013078,0.595238
1265,1265,,5,9,10,19,9,10,19,10,0.254161,0.27508,0.000014,0.006496,0.006503,0.022222
1323,1323,,5,4,4,8,4,4,8,10,0.261295,0.280317,0,0.003769,0.003746,0.5
1352,1352,,5,7,7,14,7,7,14,10,0.260728,0.280708,0.000001,0.006421,0.00645,0.47619
1356,1356,,5,5,5,10,5,5,10,10,0.266852,0.290024,0.000002,0.006462,0.006516,0.3
1359,1359,,5,14,14,28,14,14,28,10,0.293442,0.318688,0.000026,0.011729,0.0117,0.214286
1439,1439,,5,4,4,8,4,4,8,11,0.234844,0.252482,0.000001,0.002532,0.002535,0
1448,1448,,5,5,5,10,5,5,10,10,0.23996,0.258627,0.000002,0.005279,0.003189,0.4
1458,1458,,5,15,15,30,17,17,34,10,0.2886,0.313479,0.000048,0.010852,0.013023,0.3875
1486,1486,,5,33,33,66,45,45,90,10,0.297342,0.326412,0.00022,0.034681,0.034753,0.368371
1501,1501,,5,40,40,80,43,43,86,10,0.293352,0.323713,0.000058,0.039833,0.039814,0.410256
1505,1505,,5,12,12,24,12,12,24,10,0.25192,0.273341,0.000001,0.007127,0.007171,0.5
1506,1506,,5,19,19,38,22,22,44,10,0.281506,0.306259,0.000011,0.018694,0.018803,0.350877
1508,1508,,5,24,24,48,29,29,58,9,0.296639,0.323953,0.000027,0.028084,0.028114,0.365942
1515,1515,,5,40,40,80,40,40,80,10,0.282415,0.310707,0.000143,0.024102,0.024284,0.3
1519,1519,,5,43,43,86,44,44,88,10,0.299813,0.330377,0.000386,0.036539,0.036662,0.361573
1525,1525,,5,85,85,170,87,87,174,10,0.297741,0.338166,0.001453,0.055168,0.055186,0.208403
1539,1539,,5,36,36,72,36,36,72,10,0.292727,0.322114,0.000053,0.030427,0.030363,0.378571
1545,1545,,5,10,11,21,10,11,21,10,0.279056,0.301645,0.000002,0.008964,0.009555,0.363636
1550,1550,,5,30,30,60,36,37,73,10,0.29848,0.327518,0.000719,0.030234,0.02944,0.325806
1553,1553,,5,42,42,84,42,42,84,10,0.289207,0.31978,0.000133,0.029762,0.029916,0.375145
1562,1562,,5,65,65,130,68,68,136,9,0.313627,0.350372,0.00116,0.057198,0.057257,0.315625
1567,1567,,5,5,5,10,5,5,10,11,0.244659,0.263465,0,0.003301,0.003307,0.5
1650,1650,,5,24,24,48,24,24,48,10,0.280276,0.306401,0.000049,0.020891,0.020907,0.387681
1745,1745,,5,21,20,41,21,20,41,10,0.270783,0.297059,0.000029,0.019418,0.01813,0.457143
3956,3956,,5,21,21,42,21,21,42,10,0.270986,0.297732,0.000015,0.017621,0.017668,0.504762
4309,4309,,5,10,11,21,11,12,23,10,0.276463,0.300261,0.000004,0.007612,0.0081,0.418182
6493,6493,,5,7,8,15,7,8,15,10,0.265917,0.288366,0.000009,0.006482,0.006532,0.428571
350,350,,5,74,75,149,109,110,219,9,0.321739,0.360839,0.001278,0.071421,0.074151,0.277838
582,582,,5,10,10,20,10,10,20,10,0.253536,0.275666,0.000001,0.008829,0.008801,0.333333
636,636,,5,41,41,82,51,52,103,9,0.305235,0.336922,0.002717,0.035302,0.035289,0.310976
666,666,,5,23,23,46,33,32,65,10,0.298727,0.325673,0.000127,0.023365,0.023368,0.474308
1200,1200,,5,16,16,32,17,17,34,9,0.300813,0.327613,0.000012,0.025601,0.025564,0.679167
1206,1206,,5,20,20,40,22,22,44,9,0.303566,0.330605,0.000015,0.032999,0.032915,0.705263
1321,1321,,5,7,7,14,8,8,16,10,0.287909,0.309948,0.000001,0.008992,0.008935,0.714286
1452,1452,,5,35,33,68,51,50,101,9,0.303662,0.333914,0.000522,0.036754,0.036642,0.334454
1520,1520,,5,21,20,41,22,21,43,10,0.29467,0.31972,0.000029,0.027364,0.026931,0.519048
1676,1676,,5,8,8,16,9,9,18,10,0.281891,0.304607,0.000042,0.009677,0.009736,0.464286
1682,1682,,5,19,20,39,22,23,45,10,0.299751,0.325307,0.000053,0.021827,0.022116,0.465789
1688,1688,,5,51,49,100,91,89,180,9,0.309457,0.344332,0.000569,0.051861,0.051324,0.306184
1706,1706,,5,30,31,61,40,40,80,9,0.303726,0.334164,0.000194,0.033314,0.033527,0.394153
2948,2948,,7,91,92,183,142,143,285,9,0.331991,0.374689,0.006568,0.068703,0.068843,0.202819
2954,2954,,7,29,29,58,37,37,74,9,0.313015,0.343861,0.000255,0.036344,0.036441,0.533251
2988,2988,,7,49,49,98,54,54,108,10,0.272418,0.302059,0.004813,0.012509,0.012382,0.066752
4053,4053,,5,21,23,44,26,29,55,10,0.301316,0.328526,0.000045,0.026435,0.028016,0.393116
338,338,,5,15,14,29,15,15,30,10,0.29377,0.317988,0.000003,0.020615,0.019275,0.754167
347,347,,5,40,39,79,48,46,94,10,0.298202,0.328277,0.000138,0.038336,0.037295,0.376923
339,339,,5,6,6,12,6,6,12,10,0.27491,0.294628,0,0.007394,0.006846,0.607143
348,348,,5,16,15,31,22,20,42,9,0.296791,0.321528,0.000004,0.021359,0.019467,0.647059
388,388,,5,1,1,2,1,1,2,10,0.286993,0.305537,0,0.002924,0.002927,0
410,410,,5,7,7,14,8,8,16,10,0.289701,0.310705,0,0.012467,0.012437,0.761905
608,608,,5,31,31,62,36,34,70,9,0.3065,0.33672,0.000951,0.038045,0.03804,0.486022
665,665,,5,26,26,52,32,32,64,10,0.297403,0.325476,0.004451,0.019463,0.0195,0.306154
668,668,,5,38,38,76,39,39,78,10,0.29882,0.329035,0.000265,0.035409,0.035458,0.30441
772,772,,5,5,5,10,5,5,10,10,0.290722,0.311907,0,0.008765,0.008719,0.8
893,893,,30,27,26,53,35,35,70,9,0.324707,0.356063,0.002608,0.025679,0.024156,0.363301
994,994,,5,12,12,24,12,12,24,9,0.306109,0.330316,0.000686,0.014986,0.01506,0.568182
1130,1130,,5,20,18,38,29,26,55,9,0.303119,0.331176,0.000109,0.025829,0.025311,0.454762
1132,1132,,5,14,11,25,18,16,34,9,0.298789,0.322609,0.00003,0.021846,0.0126,0.566667
1145,1145,,5,14,18,32,21,24,45,9,0.307971,0.334322,0.00245,0.015334,0.01847,0.303922
1226,1226,,5,14,14,28,20,20,40,10,0.296061,0.321187,0.000006,0.022268,0.022295,0.741758
1472,1472,,5,37,37,74,49,48,97,9,0.303183,0.334272,0.001059,0.034646,0.034674,0.277027
1528,1528,,5,11,11,22,13,13,26,9,0.298572,0.323559,0.00001,0.014524,0.014531,0.554545
1609,1609,,5,12,13,25,12,13,25,10,0.293174,0.31726,0.000013,0.013431,0.015258,0.642857
1610,1610,,5,13,13,26,14,15,29,10,0.297189,0.32185,0.000004,0.019599,0.01957,0.532051
1611,1611,,5,6,6,12,6,6,12,10,0.291928,0.31443,0.000001,0.009038,0.008722,0.738095
1612,1612,,5,15,13,28,16,14,30,10,0.294941,0.319742,0.000002,0.021023,0.01901,0.67619
1646,1646,,5,16,16,32,19,19,38,10,0.298882,0.32475,0.000002,0.024842,0.024808,0.741667
1652,1652,,5,21,21,42,21,21,42,10,0.2967,0.322908,0.000121,0.02248,0.022529,0.433333
1685,1685,,5,11,11,22,12,12,24,10,0.292609,0.315585,0.000011,0.013943,0.013913,0.718182
1689,1689,,5,4,4,8,4,4,8,10,0.291162,0.31212,0,0.006979,0.006941,0.833333
1695,1695,,5,3,3,6,3,3,6,10,0.290605,0.311167,0,0.005789,0.005795,0.666667
1696,1696,,5,6,6,12,7,7,14,10,0.292076,0.313997,0,0.011151,0.01112,0.866667
1715,1715,,5,21,20,41,35,34,69,10,0.300469,0.327913,0.000066,0.024919,0.024737,0.345238
1721,1721,,5,5,5,10,5,5,10,10,0.29125,0.312496,0,0.008205,0.008218,0.9
1726,1726,,5,7,7,14,7,7,14,10,0.291574,0.313246,0,0.008429,0.00844,0.761905
1735,1735,,5,20,20,40,26,26,52,9,0.306142,0.335769,0.000053,0.029445,0.031068,0.681818
1741,1741,,5,13,13,26,15,15,30,9,0.302484,0.32979,0.00068,0.02067,0.020691,0.647436
1762,1762,,2,25,24,49,33,31,64,9,0.312947,0.341267,0.00033,0.0182,0.020272,0.498462
2050,2050,,7,23,22,45,39,36,75,10,0.305526,0.332533,0.004851,0.015356,0.013517,0.26087
2057,2057,,30,50,51,101,97,99,196,9,0.326544,0.361426,0.001236,0.038265,0.038298,0.409879
2064,2064,,30,41,42,83,65,65,130,10,0.309923,0.339937,0.000825,0.023888,0.023819,0.38676
2082,2082,,30,74,75,149,128,126,254,9,0.333873,0.371216,0.007147,0.043045,0.043173,0.234414
2194,2194,,30,49,49,98,84,82,166,9,0.319389,0.35289,0.002802,0.032211,0.032454,0.351765
2235,2235,,5,22,20,42,25,23,48,9,0.309756,0.338539,0.000334,0.02737,0.023395,0.573123
2560,2560,,34,46,45,91,76,76,152,9,0.320631,0.352854,0.009718,0.022578,0.022549,0.25942
2621,2621,,34,30,28,58,68,66,134,10,0.298048,0.324502,0.004106,0.00962,0.008576,0.292473
2882,2882,,2,8,10,18,11,14,25,10,0.283581,0.301937,0.000335,0.00626,0.003402,0.4
2901,2901,,2,6,5,11,8,7,15,10,0.287107,0.307394,0.000005,0.00713,0.004257,0.633333
2908,2908,,7,36,36,72,60,60,120,9,0.321238,0.35397,0.002827,0.02728,0.027201,0.315873
2910,2910,,7,24,23,47,33,31,64,10,0.301316,0.328287,0.001199,0.015474,0.015404,0.298913
2922,2922,,7,35,35,70,50,49,99,9,0.314859,0.344921,0.000582,0.031123,0.031234,0.383193
2942,2942,,7,9,9,18,13,13,26,10,0.292817,0.315574,0.000225,0.010782,0.010778,0.569444
2964,2964,,7,18,17,35,26,25,51,10,0.304816,0.33102,0.000607,0.018881,0.018721,0.614379
2975,2975,,7,39,39,78,56,56,112,9,0.314516,0.34693,0.001351,0.024355,0.024401,0.321154
2976,2976,,7,12,12,24,14,14,28,10,0.308729,0.334988,0.000163,0.014355,0.014364,0.545455
2979,2979,,7,25,25,50,44,46,90,10,0.293651,0.321987,0.0004,0.014504,0.011681,0.34
2983,2983,,7,52,53,105,70,69,139,9,0.330887,0.366565,0.002311,0.039969,0.042005,0.273948
2990,2990,,7,18,18,36,26,27,53,10,0.295032,0.320373,0.000125,0.012741,0.012745,0.496732
3024,3024,,30,36,34,70,65,65,130,9,0.323325,0.354022,0.002721,0.030415,0.030426,0.506006
3043,3043,,30,32,33,65,72,72,144,9,0.310156,0.338435,0.006885,0.01205,0.012069,0.217803
3131,3131,,30,32,31,63,61,61,122,9,0.318157,0.347583,0.000892,0.023443,0.022997,0.484879
3141,3141,,30,26,26,52,52,52,104,9,0.311865,0.338863,0.000952,0.018129,0.018119,0.501538
3156,3156,,30,25,26,51,32,32,64,9,0.321274,0.35137,0.002777,0.031709,0.033351,0.462963
3179,3179,,30,28,27,55,44,42,86,10,0.310824,0.341869,0.005604,0.018277,0.015275,0.376984
3199,3199,,30,40,40,80,65,65,130,9,0.325,0.356565,0.006306,0.022229,0.022101,0.263462
3205,3205,,30,46,46,92,82,82,164,9,0.329264,0.362646,0.007566,0.022368,0.022208,0.269082
3304,3304,,30,107,106,213,197,197,394,9,0.352123,0.39751,0.026272,0.05046,0.049949,0.166373
3370,3370,,30,115,115,230,228,228,456,9,0.342715,0.386335,0.012187,0.037595,0.037607,0.177511
3388,3388,,30,46,46,92,104,104,208,9,0.314242,0.342324,0.000356,0.018451,0.018474,0.508213
3885,3885,,30,128,136,264,259,267,526,9,0.368865,0.418157,0.040434,0.080809,0.082301,0.16683
3942,3942,,30,31,32,63,44,47,91,9,0.320952,0.350386,0.001368,0.017128,0.017006,0.375
3973,3973,,7,21,21,42,29,30,59,10,0.309424,0.337679,0.000256,0.027593,0.025111,0.560606
3988,3988,,2,36,37,73,59,59,118,9,0.334492,0.364648,0.009272,0.028228,0.028206,0.279352
3989,3989,,5,15,16,31,20,20,40,10,0.305106,0.33046,0.00002,0.020749,0.020817,0.633333
3992,3992,,30,45,46,91,73,73,146,9,0.335933,0.369507,0.003913,0.032911,0.031927,0.339963
4057,4057,,5,42,41,83,55,53,108,10,0.306434,0.339319,0.000644,0.04036,0.042378,0.245243
4078,4078,,7,32,32,64,55,56,111,9,0.312744,0.343413,0.000858,0.01935,0.019327,0.379032
4091,4091,,5,34,34,68,49,49,98,9,0.306923,0.338326,0.000277,0.043102,0.042463,0.410084
4105,4105,,5,8,8,16,10,10,20,9,0.293711,0.314785,0.00026,0.006345,0.006393,0.347222
4118,4118,,7,19,19,38,30,30,60,10,0.303374,0.328826,0.000404,0.013317,0.013328,0.473684
4130,4130,,5,17,17,34,23,22,45,10,0.302865,0.327567,0.001035,0.017519,0.017468,0.606618
4274,4274,,7,4,3,7,5,4,9,10,0.290869,0.312502,0.000008,0.004306,0.004236,0.5
4330,4330,,7,44,42,86,65,61,126,9,0.326803,0.362991,0.001118,0.046105,0.045018,0.408034
5803,5803,,5,5,5,10,5,5,10,10,0.291192,0.312294,0,0.007517,0.007475,0.9
341,341,,5,13,11,24,13,12,25,10,0.279353,0.302869,0.000001,0.015591,0.013708,0.769231
349,349,,5,5,5,10,7,8,15,10,0.274622,0.294195,0,0.007423,0.007463,0.85
382,382,,5,11,11,22,11,11,22,10,0.270199,0.292611,0.000669,0.012219,0.012232,0.554545
4166,4166,,5,16,16,32,16,16,32,10,0.27327,0.297375,0.000004,0.015719,0.015725,0.416667
4208,4208,,5,1,1,2,1,1,2,10,0.248301,0.263185,0,0.001447,0.001458,0
4322,4322,,5,5,5,10,5,5,10,10,0.266728,0.288286,0,0.007274,0.007303,0.6
5559,5559,,5,1,1,2,1,1,2,10,0.248301,0.263185,0,0.001447,0.001458,0
671,671,,5,23,23,46,23,23,46,10,0.286993,0.313714,0.000061,0.02071,0.020825,0.343874
1322,1322,,5,4,4,8,5,5,10,10,0.261816,0.280849,0,0.004277,0.00425,0.666667
1462,1462,,5,3,3,6,3,3,6,10,0.260164,0.277889,0,0.003853,0.003803,0.666667
499,499,,5,23,23,46,29,29,58,10,0.28484,0.31102,0.000095,0.02035,0.021292,0.336957
517,517,,5,45,45,90,60,59,119,10,0.299409,0.331043,0.000279,0.040203,0.040741,0.257005
552,552,,5,24,24,48,26,26,52,10,0.297587,0.324927,0.00023,0.024617,0.024528,0.436594
1053,1053,,5,12,13,25,15,16,31,10,0.298974,0.323854,0.000015,0.018298,0.021824,0.752747
1057,1057,,5,15,15,30,25,25,50,10,0.280167,0.303804,0.001432,0.01326,0.01323,0.390476
1470,1470,,5,1,1,2,1,1,2,10,0.260634,0.277204,0,0.001878,0.001889,0
1663,1663,,5,31,31,62,34,34,68,10,0.288398,0.316498,0.001574,0.023626,0.023602,0.226882
371,371,,5,10,9,19,13,12,25,10,0.280466,0.303614,0,0.012129,0.011292,0.677778
373,373,,5,22,22,44,24,24,48,10,0.280767,0.306068,0.000025,0.017601,0.017671,0.246753
596,596,,5,29,29,58,34,34,68,9,0.305235,0.333948,0.000279,0.036229,0.036137,0.458128
797,797,,30,15,15,30,22,26,48,9,0.308927,0.332493,0.001045,0.011585,0.011624,0.290476
1309,1309,,5,3,3,6,3,3,6,10,0.273684,0.291798,0.000002,0.003692,0.003677,0.333333
1546,1546,,5,18,18,36,18,18,36,10,0.294911,0.323154,0.000052,0.021998,0.021958,0.428105
1658,1658,,5,3,3,6,3,3,6,10,0.272521,0.290401,0,0.003651,0.003648,1
2987,2987,,7,5,5,10,6,6,12,10,0.278491,0.30068,0,0.006944,0.006931,0.8
3964,3964,,7,45,45,90,55,54,109,9,0.320916,0.354346,0.001165,0.041977,0.042068,0.326768
356,356,,5,1,1,2,1,1,2,10,0.256169,0.271161,0,0.001517,0.001514,0
688,688,,5,2,2,4,2,2,4,10,0.260234,0.277573,0,0.003107,0.003103,1
2941,2941,,7,6,6,12,9,9,18,10,0.279164,0.300615,0,0.008497,0.008472,1
498,498,,5,12,12,24,18,18,36,10,0.266975,0.29042,0.00015,0.009636,0.008868,0.282051
458,458,,5,16,15,31,17,16,33,10,0.261058,0.283722,0.000073,0.010444,0.010416,0.366667
645,645,,5,6,6,12,7,7,14,10,0.258649,0.280259,0.000001,0.006201,0.006214,0.666667
664,664,,5,24,24,48,25,25,50,10,0.272059,0.298052,0.000045,0.018816,0.018824,0.423913
355,355,,5,49,49,98,49,49,98,10,0.282139,0.31301,0.000874,0.032852,0.032843,0.265306
601,601,,5,7,7,14,7,7,14,10,0.265746,0.288435,0.000001,0.008246,0.008294,0.714286
1202,1202,,5,1,1,2,1,1,2,11,0.22007,0.232956,0,0.000527,0.000527,0
1203,1203,,5,4,5,9,4,5,9,10,0.255037,0.275809,0.000005,0.003263,0.003958,0.4
1243,1243,,5,17,17,34,29,29,58,10,0.292935,0.318518,0.000013,0.021744,0.021717,0.698529
1517,1517,,5,20,20,40,20,20,40,10,0.277313,0.302518,0.000018,0.013122,0.013237,0.457895
7459,7459,,5,3,3,6,3,3,6,10,0.242155,0.261577,0,0.00271,0.002725,0.666667
364,364,,5,6,6,12,6,6,12,10,0.251745,0.272561,0,0.00547,0.005494,0.666667
674,674,,5,20,20,40,20,20,40,10,0.285178,0.311144,0.000015,0.021376,0.021396,0.5
5592,5592,,5,7,7,14,7,7,14,10,0.259043,0.279788,0.000001,0.006897,0.006928,0.47619
1558,1558,,5,1,1,2,1,1,2,11,0.212738,0.222962,0,0.000196,0.000196,0
399,399,,7,1,1,2,1,1,2,11,0.214111,0.226619,0,0.000199,0.000201,0
4198,4198,,5,43,43,86,44,44,88,10,0.284559,0.314465,0.000185,0.032936,0.032911,0.303433
416,416,,5,1,1,2,1,1,2,10,0.249352,0.263944,0,0.00126,0.001267,0
417,417,,5,1,1,2,1,1,2,10,0.255851,0.270344,0,0.001374,0.001353,0
428,428,,5,2,1,3,2,1,3,10,0.255851,0.270344,0,0.001401,0.001353,1
429,429,,5,1,1,2,1,1,2,10,0.255851,0.270344,0,0.001374,0.001353,0
432,432,,5,1,1,2,1,1,2,10,0.255851,0.270344,0,0.001374,0.001353,0
433,433,,5,1,2,3,1,2,3,10,0.255896,0.270575,0,0.001374,0.001377,1
435,435,,5,2,1,3,2,1,3,10,0.255851,0.270344,0,0.001397,0.001353,1
437,437,,5,2,2,4,3,3,6,10,0.256306,0.271326,0.000001,0.001541,0.001521,0
438,438,,5,4,5,9,5,6,11,10,0.256397,0.271903,0.000003,0.001673,0.00165,0.2
439,439,,5,2,3,5,3,4,7,10,0.259813,0.276668,0.000001,0.002634,0.002788,0.666667
446,446,,5,3,2,5,5,4,9,10,0.255896,0.270575,0.000001,0.001506,0.001437,0.333333
448,448,,5,1,1,2,1,1,2,10,0.255851,0.270344,0,0.001374,0.001353,0
453,453,,5,2,2,4,4,4,8,10,0.256306,0.271326,0.000001,0.001541,0.001521,0
462,462,,5,3,3,6,4,4,8,10,0.259836,0.276725,0.000003,0.002674,0.002661,0.333333
463,463,,5,1,1,2,1,1,2,11,0.20377,0.21103,0.000334,0.001374,0,0.5
743,743,,5,3,3,6,3,3,6,10,0.264286,0.281298,0.000007,0.003317,0.003299,0.333333
1474,1474,,5,10,9,19,12,11,23,10,0.286565,0.309831,0.000034,0.012158,0.012077,0.544444
2949,2949,,7,6,6,12,7,7,14,10,0.26849,0.289337,0.000165,0.004388,0.00437,0.466667
4362,4362,,7,8,8,16,11,11,22,10,0.267222,0.287172,0.002016,0.004168,0.004147,0.25
5560,5560,,5,2,3,5,2,3,5,10,0.255942,0.270806,0,0.001401,0.001402,0.666667
460,460,,5,6,7,13,6,7,13,10,0.266089,0.285565,0.000023,0.005234,0.006834,0.333333
455,455,,5,1,1,2,1,1,2,10,0.255874,0.270402,0.000334,0,0.001353,0.5
728,728,,5,6,6,12,7,7,14,10,0.256397,0.273226,0.000006,0.002527,0.002491,0.466667
465,465,,5,27,30,57,35,39,74,9,0.305656,0.334572,0.000129,0.034903,0.037241,0.513793
514,514,,5,6,6,12,6,6,12,10,0.248045,0.267107,0.000001,0.005444,0.00538,0.4
1227,1227,,5,21,21,42,23,23,46,10,0.271292,0.298049,0.000026,0.019118,0.019191,0.319048
467,467,,5,20,20,40,24,24,48,10,0.292105,0.317027,0.000044,0.016748,0.016838,0.331579
488,488,,5,20,22,42,30,29,59,10,0.290839,0.31622,0.000069,0.019312,0.020402,0.331169
520,520,,5,15,15,30,16,16,32,10,0.264989,0.288902,0.000707,0.011728,0.011839,0.361905
532,532,,5,23,23,46,28,28,56,10,0.296487,0.322196,0.002261,0.020029,0.020106,0.26087
533,533,,5,6,6,12,7,7,14,10,0.263321,0.284582,0,0.006793,0.00688,0.466667
468,468,,5,7,7,14,7,7,14,10,0.26234,0.283729,0,0.007344,0.007365,0.714286
537,537,,5,25,25,50,25,25,50,10,0.266704,0.292555,0.000014,0.021535,0.021502,0.366667
600,600,,5,17,17,34,17,17,34,10,0.270174,0.295756,0.000002,0.018594,0.018654,0.636029
605,605,,5,5,5,10,5,5,10,10,0.257311,0.275632,0.000302,0.003714,0.003763,0.2
675,675,,5,8,8,16,8,8,16,10,0.263105,0.285311,0.000001,0.008561,0.008603,0.464286
1102,1102,,2,13,13,26,18,17,35,10,0.293114,0.317493,0.001419,0.012317,0.012367,0.371795
1198,1198,,5,21,22,43,39,38,77,10,0.300375,0.328572,0.000097,0.021599,0.02254,0.274892
1213,1213,,5,8,8,16,8,8,16,10,0.283469,0.307688,0.000002,0.010629,0.010772,0.464286
1231,1231,,5,8,8,16,11,11,22,10,0.28372,0.307041,0.000001,0.011991,0.012134,0.571429
1340,1340,,5,6,6,12,6,7,13,10,0.264165,0.287356,0.000001,0.006835,0.006904,0
4313,4313,,5,3,3,6,3,3,6,10,0.262411,0.282214,0,0.004673,0.004758,0.333333
5591,5591,,5,3,3,6,3,3,6,10,0.259322,0.278924,0,0.004085,0.004128,0.666667
472,472,,5,1,1,2,1,1,2,11,0.209495,0.220318,0,0.00019,0.000188,0
481,481,,5,8,9,17,8,9,17,10,0.263177,0.28464,0.002011,0.006719,0.007429,0.375
547,547,,5,8,9,17,8,9,17,10,0.263129,0.284664,0.000009,0.006947,0.00696,0.388889
597,597,,5,5,5,10,5,5,10,10,0.258301,0.277838,0.000368,0.004776,0.004828,0.5
1103,1103,,2,7,7,14,9,10,19,10,0.269896,0.291876,0.00009,0.006469,0.00651,0.714286
1276,1276,,5,2,2,4,2,2,4,10,0.259906,0.278884,0,0.002571,0.002607,0
1329,1329,,5,4,4,8,4,4,8,10,0.256625,0.274298,0,0.003803,0.00383,0
1460,1460,,5,6,6,12,7,7,14,10,0.286196,0.30857,0.000001,0.009253,0.009293,0.666667
1738,1738,,5,5,5,10,5,5,10,10,0.289439,0.310357,0.000002,0.007671,0.007766,0.2
3007,3007,,30,13,13,26,22,22,44,10,0.297771,0.324301,0.00007,0.014244,0.012132,0.604396
4197,4197,,5,6,6,12,6,6,12,10,0.289468,0.311839,0.000001,0.010123,0.010341,0.761905
493,493,,5,6,5,11,6,5,11,10,0.251088,0.269349,0.000002,0.004263,0.003805,0.452381
4347,4347,,42,2,2,4,2,2,4,11,0.208421,0.218603,0.001337,0.000119,0.000108,0
1270,1270,,5,9,9,18,9,9,18,10,0.26361,0.285746,0.000021,0.007051,0.007039,0.333333
1360,1360,,5,5,5,10,5,5,10,11,0.236887,0.255096,0,0.003428,0.003426,0.1
4315,4315,,5,11,10,21,12,12,24,10,0.289178,0.313013,0.000006,0.011121,0.011223,0.346154
603,603,,5,16,16,32,18,18,36,9,0.308366,0.333973,0.000082,0.021573,0.021057,0.430147
676,676,,5,5,5,10,5,5,10,10,0.263682,0.285415,0.000001,0.006631,0.006662,0.6
1438,1438,,5,5,5,10,5,5,10,10,0.257403,0.278875,0.000003,0.003933,0.003893,0.1
1191,1191,,5,4,4,8,4,4,8,10,0.270884,0.293315,0.000007,0.004931,0.004943,0.333333
1196,1196,,5,6,6,12,8,8,16,10,0.279516,0.303888,0.000007,0.008288,0.008333,0.6
1588,1588,,5,8,8,16,8,8,16,10,0.284728,0.310665,0.000012,0.010468,0.010451,0.535714
1662,1662,,5,3,3,6,4,4,8,10,0.254587,0.272241,0,0.00335,0.003351,0.666667
2944,2944,,7,2,2,4,3,3,6,10,0.237981,0.253385,0.000001,0.001105,0.001106,0
494,494,,5,17,17,34,22,22,44,10,0.258579,0.281607,0.000004,0.014723,0.014614,0.176471
497,497,,5,2,2,4,3,3,6,10,0.232143,0.244909,0,0.000569,0.000582,1
522,522,,5,5,6,11,5,6,11,10,0.246857,0.267159,0.000001,0.003775,0.004385,0.533333
1361,1361,,5,1,1,2,1,1,2,10,0.231213,0.243397,0,0.000427,0.000428,0
1403,1403,,5,7,8,15,8,9,17,10,0.28648,0.308002,0.000008,0.00628,0.006841,0.589286
1415,1415,,5,4,4,8,4,4,8,10,0.236674,0.250641,0.000001,0.00137,0.001382,0.083333
1405,1405,,5,3,3,6,3,3,6,11,0.24248,0.259925,0,0.002059,0.002085,0.666667
503,503,,5,5,4,9,5,4,9,10,0.236577,0.251232,0.000008,0.003344,0.001559,0.1
628,628,,5,6,6,12,10,10,20,10,0.274648,0.297414,0,0.008803,0.008864,0.866667
630,630,,5,6,6,12,7,7,14,10,0.274282,0.295987,0,0.007421,0.007466,1
1005,1005,,5,11,8,19,15,13,28,10,0.257357,0.274568,0.000743,0.003958,0.001295,0.327273
1488,1488,,5,2,2,4,2,2,4,10,0.267321,0.287215,0,0.003416,0.00345,1
1881,1881,,2,13,13,26,14,14,28,10,0.296669,0.320881,0.005307,0.010848,0.010897,0.551282
734,734,,5,7,8,15,8,9,17,10,0.286565,0.306328,0.000732,0.004691,0.005962,0.357143
907,907,,5,11,13,24,16,16,32,9,0.289556,0.309611,0.000922,0.003555,0.004387,0.333333
1177,1177,,5,16,21,37,28,33,61,9,0.303342,0.327925,0.003651,0.009067,0.012052,0.231225
1187,1187,,5,15,16,31,21,20,41,9,0.299657,0.324741,0.00202,0.007831,0.012329,0.367647
1205,1205,,5,3,2,5,3,2,5,11,0.240701,0.257647,0.000001,0.0041,0.00181,0.333333
1220,1220,,5,6,6,12,8,8,16,9,0.298356,0.320448,0.000001,0.012625,0.012622,0.866667
1250,1250,,5,4,4,8,6,6,12,10,0.291015,0.311116,0,0.007909,0.007966,0.833333
3626,3626,,2,28,27,55,36,36,72,10,0.303917,0.330323,0.000021,0.022196,0.02206,0.795566
3849,3849,,2,70,69,139,87,86,173,10,0.312981,0.344626,0.002037,0.030834,0.029173,0.338229
3858,3858,,2,72,73,145,102,103,205,9,0.332949,0.366334,0.006695,0.039383,0.038805,0.320526
508,508,,5,2,2,4,2,2,4,11,0.205863,0.215681,0,0.000138,0.000136,1
510,510,,5,1,1,2,1,1,2,10,0.239761,0.254261,0,0.001175,0.001175,0
515,515,,5,3,2,5,3,2,5,10,0.241729,0.258096,0,0.00156,0.001447,0.666667
529,529,,8,6,6,12,6,6,12,1,1,1,0.000001,0,0,0.433333
5564,5564,,8,2,2,4,2,2,4,2,0.6,0.666667,0,0,0,1
5566,5566,,8,3,3,6,3,3,6,2,0.666667,0.75,0,0,0,0.833333
5567,5567,,8,5,4,9,5,4,9,2,0.75,0.833333,0,0,0,0.5
5568,5568,,8,3,3,6,3,3,6,2,0.666667,0.75,0,0,0,0.666667
5569,5569,,8,3,4,7,3,4,7,2,0.75,0.833333,0,0,0,0.666667
5571,5571,,8,3,3,6,3,3,6,2,0.666667,0.75,0,0,0,0.666667
530,530,,5,1,1,2,1,1,2,11,0.228703,0.239669,0,0.000323,0.000321,0
531,531,,5,1,1,2,1,1,2,11,0.228703,0.239669,0,0.000323,0.000321,0
541,541,,5,1,1,2,1,1,2,11,0.228703,0.239669,0,0.000323,0.000321,0
5577,5577,,5,2,2,4,2,2,4,10,0.253647,0.27029,0,0.002503,0.002513,0
1367,1367,,5,44,44,88,44,44,88,10,0.282194,0.311058,0.000079,0.030517,0.030568,0.331395
3986,3986,,5,16,16,32,16,16,32,10,0.266408,0.288968,0.000002,0.013757,0.013786,0.483333
585,585,,5,37,37,74,43,43,86,10,0.285573,0.314829,0.000073,0.03534,0.032868,0.359175
607,607,,5,6,6,12,7,7,14,10,0.266901,0.28749,0.000001,0.006103,0.006115,0.6
733,733,,5,4,4,8,4,4,8,10,0.252427,0.272074,0,0.004279,0.004291,0.5
1193,1193,,5,1,1,2,1,1,2,11,0.239284,0.255651,0,0.001214,0.001229,0
1214,1214,,5,6,6,12,9,9,18,10,0.27876,0.301047,0,0.009021,0.009067,0.833333
1268,1268,,5,3,2,5,3,2,5,10,0.248279,0.266503,0,0.00223,0.002129,0.666667
1280,1280,,5,6,6,12,6,6,12,10,0.288947,0.312258,0.000006,0.007649,0.007592,0.266667
1289,1289,,5,5,4,9,5,4,9,10,0.261271,0.28098,0.00001,0.00481,0.004809,0.6
1376,1376,,5,3,3,6,3,3,6,10,0.260234,0.279063,0,0.003882,0.003909,1
1531,1531,,5,7,7,14,7,7,14,10,0.276941,0.297856,0.000003,0.006028,0.005995,0.333333
579,579,,2,1,1,2,1,1,2,11,0.196648,0.202691,0,0.000004,0.000004,0
2647,2647,,2,3,4,7,3,4,7,10,0.244763,0.256723,0.000835,0.000276,0.000278,0.333333
1078,1078,,5,2,2,4,2,2,4,10,0.283135,0.30252,0,0.003752,0.003713,1
1175,1175,,30,24,25,49,55,54,109,10,0.301725,0.328783,0.002224,0.017318,0.017238,0.425
1180,1180,,5,9,8,17,13,14,27,10,0.247938,0.265459,0.001583,0.004346,0.001544,0.5
1455,1455,,5,2,2,4,2,2,4,10,0.255511,0.27044,0,0.004122,0.001639,1
1476,1476,,5,5,5,10,6,6,12,10,0.256055,0.272369,0.000006,0.005824,0.003198,0.9
1871,1871,,2,51,51,102,57,58,115,10,0.323398,0.35542,0.003595,0.025514,0.02552,0.291373
2559,2559,,34,19,15,34,36,34,70,10,0.268116,0.288863,0.000746,0.012549,0.003253,0.453216
2773,2773,,2,4,5,9,7,8,15,10,0.283748,0.303542,0.00005,0.003266,0.003282,0.4
2896,2896,,2,9,8,17,12,11,23,10,0.295002,0.317923,0.000033,0.008228,0.007968,0.655556
2897,2897,,2,19,17,36,36,33,69,10,0.29413,0.318013,0.000248,0.008853,0.008096,0.377193
2916,2916,,7,7,7,14,8,8,16,10,0.286537,0.308953,0.000016,0.004799,0.004762,0.809524
3383,3383,,30,56,56,112,123,123,246,10,0.312101,0.343603,0.00121,0.018772,0.018748,0.405844
3386,3386,,30,53,53,106,127,127,254,10,0.312405,0.342621,0.000874,0.018473,0.01848,0.41074
3395,3395,,30,77,77,154,188,187,375,10,0.313287,0.347501,0.004243,0.020608,0.020653,0.291866
3473,3473,,2,31,35,66,34,38,72,10,0.313049,0.340295,0.002341,0.01931,0.021349,0.529279
4357,4357,,7,10,11,21,12,13,25,10,0.290957,0.315369,0.000114,0.007336,0.007326,0.554545
591,591,,5,15,16,31,15,16,31,10,0.292846,0.318147,0.000076,0.01792,0.020637,0.329167
604,604,,5,1,1,2,1,1,2,10,0.250152,0.266773,0,0.001853,0.001869,0
5563,5563,,5,1,1,2,1,1,2,10,0.234615,0.24714,0,0.00061,0.000611,0
612,612,,5,1,1,2,2,2,4,10,0.262006,0.277602,0,0.001916,0.001919,0
618,618,,5,1,1,2,1,1,2,10,0.262006,0.277602,0,0.001916,0.001919,0
619,619,,5,1,1,2,1,1,2,10,0.262006,0.277602,0,0.001916,0.001919,0
638,638,,5,5,5,10,6,6,12,10,0.266064,0.285115,0,0.005377,0.005381,1
742,742,,5,2,2,4,2,2,4,10,0.262078,0.27789,0.000189,0.001918,0.001922,0
3958,3958,,5,2,2,4,2,2,4,10,0.264068,0.281003,0,0.003176,0.003186,1
5595,5595,,5,3,3,6,3,3,6,10,0.264213,0.282308,0.000001,0.004044,0.004044,0.333333
631,631,,9,3,4,7,3,4,7,11,0.20455,0.214721,0,0.000095,0.000124,0.833333
635,635,,9,16,16,32,19,19,38,10,0.25076,0.269474,0.003882,0.002406,0.002405,0.1625
641,641,,9,5,4,9,6,5,11,10,0.250369,0.267135,0.000075,0.001804,0.001801,0.7
663,663,,9,16,16,32,19,19,38,10,0.256762,0.276673,0.004522,0.003439,0.003446,0.170833
4252,4252,,9,3,3,6,3,3,6,11,0.204536,0.214548,0,0.000096,0.000095,1
632,632,,9,5,7,12,7,9,16,10,0.250217,0.267135,0.001866,0.001454,0.001478,0.410714
649,649,,9,6,4,10,7,5,12,10,0.250108,0.2665,0.001113,0.001478,0.001452,0.466667
653,653,,9,2,1,3,2,1,3,11,0.204319,0.213538,0,0.000079,0.000055,1
4325,4325,,9,9,7,16,9,7,16,11,0.204463,0.214808,0.001031,0.000083,0.000081,0.347222
4328,4328,,9,6,7,13,6,7,13,11,0.204478,0.214866,0.000557,0.000103,0.000104,0.428571
4350,4350,,9,5,4,9,5,4,9,12,0.169835,0.176046,0.000164,0.000026,0.000001,0.55
634,634,,9,4,2,6,4,2,6,11,0.229266,0.241287,0,0.00033,0.000318,0.75
662,662,,9,3,5,8,3,5,8,11,0.229649,0.242552,0.000001,0.000357,0.000368,0.75
640,640,,9,2,2,4,2,2,4,10,0.249978,0.266009,0,0.001434,0.001433,1
652,652,,9,5,4,9,5,4,9,11,0.229631,0.242379,0.000001,0.000368,0.000362,0.65
4349,4349,,9,1,1,2,1,1,2,11,0.2005,0.209314,0,0.000039,0.000039,0
5580,5580,,9,3,3,6,3,3,6,11,0.200528,0.209661,0,0.00004,0.00004,0.666667
5582,5582,,9,5,5,10,5,5,10,11,0.229649,0.242552,0.000002,0.000369,0.000367,0.6
5584,5584,,9,2,2,4,2,2,4,11,0.200514,0.209488,0,0.000039,0.000039,1
5587,5587,,9,2,2,4,2,2,4,11,0.200514,0.209488,0,0.000039,0.000039,1
5590,5590,,9,1,1,2,1,1,2,11,0.2005,0.209314,0,0.000039,0.000039,0
647,647,,5,5,5,10,5,5,10,10,0.250173,0.266731,0.000001,0.002682,0.002681,0.8
651,651,,5,3,3,6,4,4,8,10,0.25,0.266038,0,0.002004,0.002004,1
659,659,,5,1,1,2,1,1,2,10,0.233874,0.246824,0,0.000566,0.000567,0
4389,4389,,5,3,3,6,3,3,6,10,0.25,0.266038,0,0.001994,0.001994,1
5586,5586,,5,5,5,10,5,5,10,10,0.250043,0.266384,0.000001,0.00204,0.00204,0.6
637,637,,9,3,5,8,3,5,8,12,0.169855,0.176277,0.000001,0.000002,0.000004,0.55
4327,4327,,9,5,5,10,5,5,10,11,0.200291,0.20943,0.00018,0.000003,0.000027,0.566667
5589,5589,,9,3,3,6,3,3,6,11,0.200208,0.208852,0.000083,0.000025,0.000025,0.666667
642,642,,5,1,1,2,1,1,2,10,0.24974,0.265258,0,0.001395,0.001395,0
655,655,,5,1,1,2,1,1,2,10,0.24974,0.265258,0,0.001395,0.001395,0
656,656,,5,2,2,4,2,2,4,10,0.257794,0.275114,0,0.002985,0.002984,1
658,658,,9,2,2,4,2,2,4,10,0.25,0.26598,0,0.00145,0.00145,1
660,660,,5,1,1,2,1,1,2,10,0.24974,0.265258,0,0.001395,0.001395,0
4345,4345,,5,3,3,6,3,3,6,10,0.249784,0.265605,0,0.001451,0.001451,1
5585,5585,,5,3,3,6,3,3,6,10,0.249784,0.265605,0,0.001451,0.001451,1
646,646,,9,2,2,4,2,2,4,11,0.204376,0.213884,0,0.000057,0.000057,1
5581,5581,,9,3,2,5,3,2,5,11,0.229266,0.241287,0,0.000324,0.000318,0.666667
5588,5588,,9,2,3,5,2,3,5,11,0.204405,0.214115,0,0.000057,0.00008,0.666667
5583,5583,,9,2,4,6,2,4,6,11,0.229302,0.241634,0,0.000319,0.000329,0.583333
708,708,,5,9,9,18,10,10,20,10,0.263899,0.284607,0.000434,0.007062,0.007021,0.277778
1541,1541,,5,11,11,22,11,11,22,10,0.256465,0.276062,0.000013,0.006714,0.006689,0.181818
2945,2945,,5,4,4,8,4,4,8,10,0.274883,0.294776,0.000003,0.005149,0.005135,0.5
2947,2947,,7,15,15,30,18,18,36,10,0.295213,0.323097,0.000096,0.019025,0.019124,0.628571
2952,2952,,7,9,9,18,10,10,20,10,0.274726,0.297652,0.00001,0.009302,0.009261,0.75
685,685,,5,1,1,2,1,1,2,10,0.255987,0.271811,0,0.00159,0.001589,0
721,721,,5,3,3,6,4,4,8,10,0.256283,0.27259,0,0.00238,0.002343,1
739,739,,5,2,3,5,2,3,5,10,0.256306,0.272648,0.00006,0.002285,0.002271,0.333333
5593,5593,,5,4,4,8,4,4,8,10,0.256328,0.272821,0.000002,0.002391,0.002375,0.833333
693,693,,5,1,1,2,1,1,2,11,0.210749,0.219606,0,0.000066,0.000066,0
698,698,,10,2,2,4,2,2,4,10,0.256033,0.272042,0.000669,0.00159,0.001589,0
714,714,,10,1,1,2,1,1,2,11,0.203857,0.211718,0,0.000026,0.000026,0
703,703,,5,1,1,2,1,1,2,10,0.255987,0.271811,0,0.00159,0.001589,0
705,705,,5,1,1,2,1,1,2,10,0.255987,0.271811,0,0.00159,0.001589,0
707,707,,5,1,1,2,1,1,2,10,0.255987,0.271811,0,0.00159,0.001589,0
731,731,,5,3,2,5,3,2,5,11,0.211553,0.22136,0.000001,0.00018,0.000144,0
709,709,,5,2,2,4,3,3,6,10,0.256078,0.272128,0.000002,0.001656,0.001655,0
711,711,,5,3,3,6,3,3,6,10,0.260164,0.279636,0.000001,0.003243,0.003243,0.666667
715,715,,11,1,1,2,1,1,2,11,0.203886,0.211805,0,0.000026,0.000026,0
718,718,,11,3,3,6,4,4,8,10,0.256078,0.272273,0.001337,0.001591,0.00159,0
5598,5598,,11,1,1,2,1,1,2,11,0.203886,0.211805,0,0.000026,0.000026,0
719,719,,12,2,2,4,2,2,4,10,0.256033,0.272042,0.000669,0.00159,0.001589,0
730,730,,12,1,1,2,1,1,2,11,0.203857,0.211718,0,0.000026,0.000026,0
722,722,,5,1,1,2,1,1,2,10,0.255987,0.271811,0,0.00159,0.001589,0
724,724,,5,2,2,4,2,2,4,10,0.256033,0.272042,0,0.001685,0.001664,1
726,726,,5,2,2,4,2,2,4,10,0.257196,0.274669,0.000001,0.002129,0.002125,0
729,729,,13,2,2,4,2,2,4,10,0.256033,0.272042,0.000669,0.00159,0.001589,0
5599,5599,,13,1,1,2,1,1,2,11,0.203857,0.211718,0,0.000026,0.000026,0
6737,6737,,5,1,1,2,1,1,2,11,0.222754,0.231687,0,0.000096,0.000075,0
746,746,,5,3,3,6,4,4,8,10,0.256124,0.272359,0.000004,0.001709,0.001708,0
5594,5594,,14,2,2,4,2,2,4,10,0.256033,0.272042,0.000669,0.00159,0.001589,0
5597,5597,,5,1,1,2,1,1,2,10,0.255987,0.271811,0,0.00159,0.001589,0
5952,5952,,5,9,7,16,11,10,21,10,0.2886,0.311559,0.000005,0.010331,0.009471,0.736111
794,794,,30,2,2,4,2,2,4,10,0.255557,0.270543,0,0.000855,0.000886,1
799,799,,30,5,5,10,10,11,21,10,0.282526,0.301231,0.00011,0.003035,0.003086,0.7
800,800,,30,2,2,4,3,3,6,10,0.255557,0.270543,0,0.000855,0.000886,1
820,820,,30,2,2,4,2,2,4,10,0.236054,0.24623,0,0.000236,0.000235,1
838,838,,30,2,2,4,3,3,6,10,0.255557,0.270543,0,0.000855,0.000886,1
6778,6778,,5,3,3,6,3,3,6,10,0.255602,0.270774,0,0.000958,0.000988,1
804,804,,5,1,1,2,2,2,4,10,0.255511,0.270312,0,0.000669,0.0007,0
877,877,,5,2,2,4,2,2,4,10,0.255534,0.270485,0,0.00069,0.00072,1
879,879,,5,4,4,8,4,4,8,10,0.255624,0.270947,0,0.000772,0.00079,0.833333
880,880,,5,4,4,8,4,4,8,10,0.255579,0.270832,0,0.000805,0.000744,0.55
881,881,,5,7,7,14,9,9,18,10,0.257311,0.274337,0.000011,0.001261,0.001323,0.52381
906,906,,5,2,2,4,3,3,6,10,0.255579,0.270601,0,0.000739,0.000757,1
916,916,,43,16,16,32,23,23,46,10,0.306045,0.330818,0.001377,0.00893,0.008941,0.329167
918,918,,43,26,23,49,32,28,60,10,0.302611,0.32816,0.013156,0.007534,0.007547,0.143875
930,930,,43,8,10,18,9,11,20,10,0.289875,0.311532,0.001461,0.003618,0.006011,0.466667
974,974,,15,5,6,11,6,7,13,10,0.255783,0.271554,0.000076,0.000763,0.000838,0.466667
976,976,,15,3,3,6,3,3,6,10,0.25567,0.270919,0,0.000734,0.000764,1
979,979,,15,13,13,26,21,20,41,10,0.271445,0.293043,0.001369,0.003253,0.00329,0.25
988,988,,15,4,4,8,5,5,10,10,0.255692,0.271092,0.000124,0.000736,0.000766,0.75
990,990,,15,4,3,7,5,4,9,10,0.25567,0.270919,0.000334,0.000734,0.000764,0.5
1004,1004,,5,3,3,6,3,3,6,10,0.255602,0.270774,0,0.000701,0.000865,0.583333
1013,1013,,5,3,4,7,4,5,9,10,0.256192,0.2719,0,0.000768,0.000931,0.666667
1016,1016,,5,7,7,14,9,10,19,10,0.258579,0.276526,0.000008,0.001737,0.001815,0.666667
1020,1020,,5,16,19,35,28,31,59,10,0.292817,0.316979,0.005112,0.006051,0.008428,0.260526
1038,1038,,5,8,10,18,12,14,26,10,0.25895,0.277537,0.000893,0.001779,0.001793,0.277778
1186,1186,,5,7,7,14,14,14,28,9,0.295122,0.316367,0.001077,0.003574,0.005098,0.511111
3351,3351,,30,35,34,69,61,60,121,10,0.305753,0.333546,0.007074,0.010111,0.010175,0.235294
888,888,,5,7,7,14,11,11,22,10,0.286565,0.307321,0.000006,0.004623,0.004637,0.714286
999,999,,5,8,6,14,8,7,15,10,0.285827,0.305906,0.000355,0.004439,0.004152,0.446429
890,890,,5,1,1,2,1,1,2,11,0.226069,0.236268,0,0.000118,0.000115,0
891,891,,5,8,9,17,11,12,23,10,0.292076,0.315024,0.0007,0.007168,0.007368,0.430556
894,894,,30,1,1,2,1,1,2,10,0.245137,0.257886,0,0.000388,0.000412,0
917,917,,30,1,1,2,2,2,4,10,0.245137,0.257886,0,0.000388,0.000412,0
3339,3339,,30,56,56,112,103,102,205,10,0.320275,0.353872,0.010856,0.015783,0.015791,0.177597
901,901,,5,1,2,3,1,2,3,11,0.222376,0.231758,0.000334,0.000169,0.000071,0.5
898,898,,5,1,1,2,1,1,2,11,0.225258,0.235928,0.000002,0.000001,0.00017,0.5
908,908,,5,1,1,2,1,1,2,10,0.224556,0.23345,0,0.00007,0.000057,0
910,910,,5,3,3,6,3,3,6,10,0.242888,0.257471,0,0.000564,0.000551,0.666667
912,912,,43,8,7,15,10,9,19,10,0.247407,0.263562,0.000807,0.003563,0.000827,0.486111
914,914,,43,2,3,5,2,3,5,11,0.23308,0.244571,0,0.00011,0.000209,0.916667
915,915,,43,9,6,15,13,12,25,11,0.236596,0.249026,0.000199,0.001853,0.000389,0.527778
929,929,,43,6,8,14,7,9,16,11,0.233533,0.245985,0.003006,0.000243,0.000272,0.321429
4119,4119,,30,10,10,20,15,17,32,10,0.284307,0.305281,0.00016,0.003847,0.003834,0.354545
923,923,,43,6,6,12,6,6,12,11,0.23648,0.248847,0.000017,0.000374,0.000358,0.666667
921,921,,43,6,6,12,7,7,14,11,0.235592,0.247504,0.000015,0.000273,0.000273,0.466667
920,920,,43,2,2,4,2,2,4,11,0.232348,0.2433,0,0.000125,0.000125,1
922,922,,43,4,4,8,4,4,8,11,0.232442,0.243791,0.001337,0.000125,0.000125,0.333333
927,927,,43,3,3,6,3,3,6,11,0.232367,0.243473,0,0.000128,0.000127,1
932,932,,43,4,4,8,4,4,8,11,0.232386,0.243647,0,0.00013,0.000129,0.833333
933,933,,43,4,4,8,4,4,8,11,0.232386,0.243647,0,0.000133,0.000133,0.666667
937,937,,43,2,2,4,2,2,4,11,0.232348,0.2433,0,0.000123,0.000123,1
941,941,,43,1,1,2,1,1,2,12,0.188566,0.194375,0.000334,0.000121,0,0.5
943,943,,43,3,3,6,3,3,6,11,0.232405,0.24356,0,0.000125,0.000125,0.666667
5617,5617,,43,2,2,4,2,2,4,11,0.232386,0.243387,0,0.000123,0.000123,1
5629,5629,,43,2,2,4,2,2,4,12,0.18864,0.194768,0.000669,0.000002,0.000002,0
931,931,,43,1,1,2,1,1,2,16,0.107642,0.109133,0.00167,0.000004,0,0
935,935,,43,1,1,2,1,1,2,12,0.189333,0.195656,0,0.000004,0.000004,0
5625,5625,,43,1,1,2,1,1,2,11,0.232348,0.243185,0,0.000004,0.000121,1
5619,5619,,43,1,1,2,1,1,2,15,0.120592,0.122455,0.00167,0,0,0
939,939,,43,1,1,2,1,1,2,11,0.232348,0.243185,0.000334,0,0.000121,0.5
942,942,,43,1,1,2,1,1,2,13,0.158711,0.162363,0,0,0,0
946,946,,5,1,1,2,2,2,4,10,0.239145,0.250264,0,0.000236,0.000256,0
948,948,,5,2,2,4,2,2,4,10,0.239165,0.250437,0,0.000241,0.00026,1
5632,5632,,5,7,7,14,7,7,14,10,0.239264,0.251303,0.000001,0.000263,0.000281,0.404762
949,949,,5,3,3,6,3,3,6,10,0.239184,0.25061,0,0.000245,0.000264,1
953,953,,5,3,3,6,3,3,6,10,0.239184,0.25061,0,0.000245,0.000264,1
957,957,,5,1,1,2,1,1,2,10,0.239145,0.250264,0,0.000236,0.000256,0
958,958,,5,1,1,2,1,1,2,10,0.239145,0.250264,0,0.000236,0.000256,0
959,959,,5,4,4,8,4,4,8,10,0.239681,0.251557,0.000001,0.000348,0.000366,0.666667
960,960,,5,1,1,2,1,1,2,10,0.239145,0.250264,0,0.000236,0.000256,0
973,973,,5,2,2,4,4,4,8,10,0.255308,0.271528,0,0.00158,0.001567,1
5630,5630,,5,3,4,7,3,4,7,10,0.239204,0.250784,0,0.000247,0.000269,0.833333
5633,5633,,5,3,2,5,3,2,5,10,0.239165,0.250437,0,0.000245,0.00026,1
967,967,,5,1,1,2,1,1,2,11,0.225293,0.235386,0,0.000109,0.000101,0
971,971,,5,1,1,2,1,1,2,11,0.225293,0.235386,0,0.000109,0.000101,0
984,984,,15,5,5,10,6,6,12,10,0.243729,0.258638,0.000671,0.000542,0.000542,0.4
986,986,,15,3,2,5,3,2,5,11,0.213525,0.223617,0,0.000079,0.000064,1
977,977,,15,1,1,2,1,1,2,11,0.19598,0.203426,0,0.000009,0.000009,0
985,985,,15,4,4,8,4,4,8,10,0.243977,0.259042,0.000002,0.00072,0.000672,0.666667
5637,5637,,15,1,1,2,1,1,2,11,0.213509,0.223444,0,0.000053,0.000052,0
995,995,,5,1,1,2,1,1,2,10,0.234386,0.244779,0,0.000242,0.00024,0
3967,3967,,30,9,9,18,9,10,19,10,0.284027,0.304973,0.001352,0.004803,0.004755,0.416667
1001,1001,,5,1,1,2,1,1,2,11,0.204695,0.212987,0,0.000021,0.000064,0
1026,1026,,16,3,2,5,5,5,10,11,0.226548,0.237228,0.000334,0.000137,0.000099,0.5
1028,1028,,16,2,3,5,4,4,8,11,0.226566,0.237401,0.000334,0.000137,0.000099,0.5
1031,1031,,5,5,4,9,9,8,17,10,0.234329,0.246694,0.000015,0.000339,0.000228,0.45
1036,1036,,5,4,4,8,6,6,12,11,0.226637,0.237719,0.000336,0.000143,0.000105,0.35
1037,1037,,5,2,3,5,3,3,6,11,0.22662,0.237546,0,0.000137,0.000105,1
1042,1042,,5,3,3,6,6,6,12,11,0.22662,0.237575,0,0.000166,0.000128,1
1043,1043,,5,3,3,6,8,7,15,11,0.22662,0.237575,0,0.000166,0.000128,1
1027,1027,,16,1,1,2,1,1,2,12,0.184728,0.190502,0,0.000002,0.000002,1
1033,1033,,5,2,3,5,2,3,5,10,0.230825,0.242147,0.000005,0.000202,0.000133,0.666667
1035,1035,,5,1,0,1,1,0,1,0,0,0,0,0.000002,0,0
1039,1039,,5,1,0,1,1,0,1,0,0,0,0,0.000029,0,0
1041,1041,,5,1,0,1,1,0,1,0,0,0,0,0.000029,0,0
1047,1047,,17,2,2,4,2,2,4,11,0.22614,0.237348,0.000669,0.000165,0.000182,0
1048,1048,,17,1,1,2,1,1,2,12,0.184444,0.190455,0,0.000003,0.000003,0
6510,6510,,5,3,3,6,3,3,6,10,0.24066,0.257818,0,0.002978,0.002967,0.333333
1052,1052,,5,2,2,4,2,2,4,11,0.236577,0.252069,0,0.001372,0.00137,1
5672,5672,,5,2,2,4,2,2,4,10,0.25497,0.272147,0,0.002235,0.002226,0
5674,5674,,2,11,10,21,17,16,33,9,0.293681,0.316283,0.000661,0.006822,0.006549,0.309091
7933,7933,,5,4,4,8,4,4,8,10,0.245701,0.264532,0,0.004225,0.004219,0.166667
5659,5659,,5,1,1,2,1,1,2,11,0.218868,0.229415,0,0.000212,0.000213,0
6756,6756,,5,1,1,2,1,1,2,11,0.218868,0.229415,0,0.000212,0.000213,0
7429,7429,,5,1,1,2,1,1,2,11,0.187878,0.194433,0,0.000008,0.000009,0
1077,1077,,5,3,2,5,3,2,5,10,0.25986,0.277026,0,0.002653,0.002057,1
5670,5670,,5,3,3,6,3,3,6,10,0.252803,0.267914,0,0.002258,0.002202,1
1065,1065,,5,1,1,2,1,1,2,10,0.250065,0.264218,0,0.001075,0.001069,0
1068,1068,,5,0,1,1,0,1,1,10,0.250108,0.2643,0,0,0.001069,0
1072,1072,,5,3,3,6,4,4,8,10,0.286139,0.306645,0.000002,0.004373,0.00433,0.333333
1534,1534,,5,6,6,12,6,6,12,10,0.253003,0.270438,0.000002,0.003149,0.003134,0.066667
5671,5671,,5,2,2,4,2,2,4,10,0.25986,0.277026,0,0.002075,0.002057,1
1330,1330,,5,2,1,3,2,1,3,10,0.249676,0.265131,0,0.001605,0.000988,1
5665,5665,,5,3,3,6,5,6,11,10,0.257702,0.27327,0.000002,0.001783,0.001743,0.666667
1104,1104,,2,2,2,4,3,3,6,10,0.232855,0.244303,0,0.000304,0.000307,1
1105,1105,,2,1,1,2,1,1,2,11,0.226691,0.2374,0,0.000198,0.000198,0
1106,1106,,2,3,3,6,5,5,10,10,0.251328,0.267745,0,0.001647,0.001618,1
5675,5675,,2,3,3,6,4,4,8,10,0.232873,0.244476,0,0.000408,0.000411,1
1109,1109,,18,1,1,2,1,1,2,11,0.195026,0.202201,0,0.000468,0.000008,1
1111,1111,,20,2,2,4,3,3,6,10,0.242236,0.256143,0.000334,0.000469,0.000488,0
1112,1112,,19,3,3,6,5,5,10,10,0.242521,0.256634,0.000001,0.000538,0.000557,0.666667
1113,1113,,18,2,2,4,2,2,4,10,0.242216,0.256085,0,0.000476,0.000495,1
1114,1114,,20,3,3,6,3,3,6,10,0.242256,0.256316,0.001002,0.000469,0.000488,0.333333
1116,1116,,18,4,3,7,5,4,9,10,0.242236,0.256258,0.001003,0.000477,0.000495,0.25
1118,1118,,21,2,2,4,3,3,6,10,0.242216,0.256085,0.000669,0.000468,0.000488,0
1121,1121,,5,5,5,10,7,7,14,10,0.24495,0.260722,0.000015,0.001745,0.001032,0.6
1173,1173,,5,4,4,8,12,12,24,10,0.245492,0.261496,0.000001,0.001408,0.001357,0.833333
3980,3980,,30,25,25,50,40,41,81,10,0.29467,0.322092,0.001472,0.014222,0.016109,0.430199
7417,7417,,19,4,4,8,4,4,8,10,0.242277,0.256489,0.001337,0.000478,0.000497,0.166667
1110,1110,,20,2,2,4,2,2,4,11,0.195053,0.202403,0,0.000008,0.000008,1
1117,1117,,20,3,3,6,3,3,6,11,0.195066,0.202576,0,0.000016,0.000015,0.333333
1119,1119,,18,1,1,2,1,1,2,11,0.195013,0.202143,0,0.000008,0.000008,0
5601,5601,,21,1,1,2,1,1,2,11,0.195,0.202085,0,0.000008,0.000008,0
1149,1149,,5,4,1,5,4,2,6,10,0.242684,0.256663,0.000321,0.000491,0.000465,0.75
5687,5687,,5,5,5,10,8,8,16,10,0.242888,0.257644,0.000353,0.000577,0.000541,0.4
1122,1122,,30,4,5,9,6,5,11,10,0.279787,0.297674,0.000065,0.002014,0.002081,0.45
3974,3974,,30,10,10,20,12,13,25,10,0.282415,0.302877,0.000717,0.005532,0.005465,0.444444
3977,3977,,30,14,14,28,18,17,35,10,0.283832,0.304981,0.000019,0.008507,0.008033,0.638095
1126,1126,,30,12,12,24,14,14,28,10,0.267247,0.289448,0.000051,0.006143,0.006185,0.469697
2191,2191,,30,53,54,107,68,67,135,10,0.29043,0.323049,0.001449,0.020745,0.021994,0.240391
1127,1127,,22,1,1,2,1,1,2,11,0.202583,0.210438,0,0.000019,0.000019,0
1136,1136,,22,2,2,4,2,2,4,10,0.254027,0.26985,0.000669,0.001204,0.001201,0
2059,2059,,30,10,10,20,11,11,22,10,0.281479,0.301491,0.000032,0.005208,0.005263,0.711111
2067,2067,,30,7,7,14,7,7,14,10,0.281396,0.300971,0.000009,0.005018,0.005066,0.904762
2096,2096,,30,4,4,8,4,4,8,10,0.281314,0.300452,0,0.004427,0.0044,1
2190,2190,,30,4,4,8,4,4,8,10,0.254857,0.271655,0,0.002185,0.001216,0.5
2239,2239,,30,5,5,10,5,5,10,10,0.263129,0.282783,0,0.003805,0.003685,1
3975,3975,,30,5,6,11,6,7,13,10,0.26146,0.280345,0.000001,0.002599,0.003289,0.733333
3976,3976,,30,3,3,6,4,4,8,10,0.260305,0.278486,0,0.002204,0.002153,1
5691,5691,,30,5,5,10,6,6,12,10,0.262078,0.281448,0,0.003627,0.003583,1
5702,5702,,30,3,2,5,6,5,11,10,0.254139,0.270139,0,0.003269,0.001479,1
1138,1138,,5,2,1,3,3,2,5,10,0.242684,0.256663,0,0.000473,0.000465,1
1140,1140,,5,2,3,5,4,5,9,10,0.242766,0.257125,0,0.000476,0.000484,0.666667
1183,1183,,5,8,6,14,14,12,26,10,0.243195,0.258395,0.001635,0.000694,0.000689,0.196429
1141,1141,,23,2,2,4,2,2,4,10,0.242725,0.256894,0.000669,0.000465,0.000466,0
1143,1143,,23,1,1,2,1,1,2,11,0.19533,0.202529,0,0.000007,0.000007,0
1144,1144,,24,3,3,6,4,4,8,10,0.242909,0.257413,0.000349,0.000474,0.000483,0.5
1147,1147,,24,9,7,16,16,16,32,11,0.19887,0.208651,0.002674,0.000341,0.00009,0.138889
5694,5694,,24,3,3,6,4,5,9,10,0.242909,0.257413,0.000022,0.000769,0.000479,0.583333
7976,7976,,24,3,2,5,4,3,7,10,0.235592,0.247053,0.000206,0.000763,0.000252,0.5
5692,5692,,24,1,1,2,2,2,4,12,0.165891,0.171237,0,0.000001,0.000005,0
5695,5695,,24,2,3,5,4,5,9,12,0.16591,0.171583,0,0.000002,0.000006,0.666667
6773,6773,,24,2,2,4,2,2,4,12,0.1659,0.17141,0,0.000002,0.000005,1
7424,7424,,24,2,1,3,5,3,8,12,0.165891,0.171237,0,0.000002,0.000005,1
1152,1152,,5,1,1,2,1,1,2,10,0.245304,0.259303,0,0.000708,0.000706,0
1153,1153,,5,1,1,2,1,1,2,11,0.223288,0.233278,0,0.000147,0.000185,0
5696,5696,,5,2,2,4,2,2,4,10,0.245366,0.259591,0,0.000855,0.000891,1
1162,1162,,5,1,1,2,1,1,2,10,0.245304,0.259303,0,0.000708,0.000706,0
5697,5697,,5,1,1,2,1,1,2,10,0.245304,0.259303,0,0.000708,0.000706,0
5699,5699,,5,1,1,2,2,2,4,10,0.245304,0.259303,0,0.000708,0.000706,0
5805,5805,,5,1,1,2,1,1,2,10,0.245304,0.259303,0,0.000708,0.000706,0
1166,1166,,5,1,1,2,1,1,2,11,0.206793,0.215722,0,0.000036,0.00011,0
1169,1169,,30,2,3,5,6,7,13,11,0.231844,0.243556,0,0.000281,0.000287,1
5701,5701,,30,3,3,6,7,7,14,11,0.231844,0.243556,0,0.000286,0.000287,0.833333
6768,6768,,30,3,2,5,4,3,7,11,0.231826,0.243383,0,0.000286,0.000283,1
3410,3410,,30,11,13,24,17,19,36,10,0.287364,0.3103,0.000001,0.010958,0.01183,0.846154
1176,1176,,25,2,1,3,2,1,3,10,0.227908,0.237396,0.000669,0.000193,0.000057,0.333333
1182,1182,,5,1,1,2,2,2,4,10,0.232761,0.24317,0,0.000193,0.000146,0
5706,5706,,5,1,1,2,1,1,2,11,0.195648,0.203251,0,0.000193,0.000011,1
5707,5707,,5,1,1,2,1,1,2,11,0.195648,0.203251,0,0.000193,0.000011,1
5708,5708,,5,1,1,2,1,1,2,11,0.188887,0.194572,0.00005,0.000193,0,0.5
1181,1181,,25,1,1,2,1,1,2,11,0.185659,0.190895,0.000335,0,0.000003,0
5703,5703,,5,1,1,2,2,2,4,11,0.195634,0.203193,0,0.000011,0.000011,0
5704,5704,,5,2,2,4,2,2,4,10,0.232836,0.243516,0.000334,0.000011,0.000157,0.5
5709,5709,,5,1,1,2,1,1,2,10,0.230585,0.241379,0,0.000198,0.000126,0
2940,2940,,7,12,10,22,14,12,26,10,0.292609,0.317668,0.000011,0.015058,0.012934,0.80303
1223,1223,,5,5,5,10,6,6,12,10,0.28104,0.303452,0,0.00757,0.007615,0.8
7489,7489,,5,2,2,4,2,2,4,10,0.286281,0.305865,0,0.004838,0.004824,1
1767,1767,,2,17,14,31,20,20,40,10,0.297372,0.31831,0.000037,0.013858,0.010745,0.761029
1905,1905,,2,5,4,9,6,5,11,10,0.259813,0.27561,0.00001,0.004146,0.001562,0.5
2443,2443,,34,9,11,20,10,12,22,10,0.280876,0.303089,0.001039,0.003424,0.00391,0.490909
2688,2688,,2,18,17,35,27,27,54,10,0.276781,0.29938,0.004824,0.007257,0.004806,0.230994
2715,2715,,2,10,11,21,14,15,29,10,0.281534,0.303432,0.002302,0.003857,0.003891,0.2
2745,2745,,2,12,12,24,15,15,30,10,0.292906,0.315464,0.000147,0.007142,0.007154,0.515152
2771,2771,,34,15,13,28,21,21,42,10,0.287823,0.309989,0.0063,0.005056,0.005094,0.22381
2816,2816,,34,12,12,24,17,17,34,10,0.288889,0.312011,0.0005,0.00581,0.005854,0.621795
2890,2890,,2,33,33,66,47,46,93,10,0.307119,0.332528,0.002645,0.020712,0.020845,0.411932
1425,1425,,5,1,1,2,1,1,2,10,0.241365,0.256907,0,0.001401,0.001399,0
1262,1262,,5,1,1,2,1,1,2,10,0.249676,0.265131,0,0.001,0.000988,0
1279,1279,,5,2,1,3,2,1,3,10,0.249676,0.265131,0.000002,0.001104,0.000988,0
1278,1278,,5,3,3,6,3,3,6,10,0.250543,0.266591,0,0.001219,0.001208,0.666667
1274,1274,,5,2,2,4,2,2,4,10,0.285516,0.30549,0,0.003665,0.003625,0
1324,1324,,5,6,6,12,6,6,12,10,0.286338,0.307424,0.000051,0.006656,0.006594,0.6
1285,1285,,5,1,2,3,1,2,3,10,0.250065,0.26587,0.000001,0.001,0.001065,0
1313,1313,,5,1,1,2,1,1,2,10,0.249676,0.265131,0,0.001,0.000988,0
1339,1339,,5,1,1,2,1,1,2,10,0.249676,0.265131,0,0.001,0.000988,0
1344,1344,,5,1,1,2,1,1,2,10,0.249676,0.265131,0,0.001,0.000988,0
1350,1350,,5,2,2,4,2,2,4,10,0.245722,0.261663,0,0.001617,0.001616,0
4264,4264,,5,1,1,2,2,2,4,10,0.25063,0.264812,0,0.001333,0.001322,0
5638,5638,,5,1,1,2,1,1,2,10,0.25063,0.264812,0,0.001333,0.001322,0
1602,1602,,7,5,4,9,6,4,10,10,0.290313,0.312443,0.000003,0.007872,0.006512,0.8
1743,1743,,7,3,3,6,6,6,12,10,0.289236,0.311034,0.000003,0.004711,0.004721,0.333333
2359,2359,,30,53,54,107,109,109,218,10,0.320204,0.350674,0.016036,0.012451,0.01246,0.062893
3536,3536,,2,43,43,86,60,59,119,9,0.320631,0.348929,0.001867,0.027418,0.027492,0.549834
3570,3570,,2,23,23,46,28,29,57,9,0.311394,0.336449,0.000047,0.020439,0.020603,0.871377
6152,6152,,7,6,4,10,7,5,12,10,0.266236,0.284999,0.000008,0.007621,0.002993,0.633333
1412,1412,,5,1,1,2,1,1,2,10,0.249676,0.265131,0,0.001,0.000988,0
1416,1416,,5,1,1,2,1,1,2,10,0.249676,0.265131,0,0.001,0.000988,0
2774,2774,,34,3,3,6,5,5,10,10,0.25452,0.270823,0.000079,0.001072,0.001062,0.333333
1422,1422,,5,1,1,2,1,1,2,10,0.235939,0.248894,0,0.000363,0.000696,1
1446,1446,,5,1,1,2,2,2,4,10,0.254497,0.268973,0,0.001446,0.001444,0
1450,1450,,5,1,1,2,2,2,4,10,0.254497,0.268973,0,0.001446,0.001444,0
1451,1451,,5,1,1,2,1,1,2,10,0.254497,0.268973,0,0.001446,0.001444,0
1469,1469,,5,6,6,12,8,8,16,10,0.282056,0.302624,0.000017,0.003223,0.005815,0.690476
1480,1480,,5,3,3,6,3,3,6,10,0.25497,0.270186,0.000332,0.002035,0.002035,0.333333
1454,1454,,5,1,1,2,1,1,2,10,0.254497,0.268973,0,0.001446,0.001444,0
1456,1456,,5,2,3,5,2,3,5,10,0.255421,0.270936,0,0.002003,0.00259,1
1464,1464,,5,3,3,6,3,3,6,10,0.254924,0.270012,0,0.001678,0.001641,0.666667
1459,1459,,5,3,3,6,3,3,6,10,0.255783,0.271502,0.000336,0.002003,0.002001,0.333333
1461,1461,,5,2,2,4,2,2,4,11,0.203842,0.211797,0,0.000065,0.000065,0
4190,4190,,5,2,2,4,2,2,4,10,0.25452,0.269146,0,0.001472,0.001471,1
1465,1465,,5,2,2,4,2,2,4,10,0.25452,0.269146,0,0.001539,0.001495,1
1468,1468,,5,1,1,2,2,2,4,10,0.254497,0.268973,0,0.001446,0.001444,0
4196,4196,,5,1,1,2,1,1,2,10,0.232667,0.245486,0,0.000556,0.000556,0
1475,1475,,5,1,1,2,1,1,2,10,0.254497,0.268973,0,0.001446,0.001444,0
1479,1479,,5,1,1,2,2,2,4,10,0.254497,0.268973,0,0.001446,0.001444,0
1500,1500,,5,1,1,2,1,1,2,11,0.229887,0.2421,0,0.000472,0.000485,0
1502,1502,,5,4,4,8,4,4,8,10,0.265819,0.282789,0.000669,0.003061,0.003167,0.333333
5713,5713,,5,1,1,2,1,1,2,11,0.210013,0.218139,0,0.000051,0.000049,0
1510,1510,,5,1,1,2,1,1,2,10,0.232442,0.245136,0,0.000602,0.00063,0
1511,1511,,5,1,1,2,1,1,2,10,0.232442,0.245136,0,0.000602,0.00063,0
1514,1514,,5,5,5,10,9,9,18,10,0.27575,0.294362,0,0.006117,0.006112,0.6
1651,1651,,5,3,3,6,3,3,6,10,0.241365,0.258783,0,0.002183,0.002182,0.333333
1654,1654,,5,3,3,6,3,3,6,10,0.276304,0.295373,0,0.0036,0.003576,1
1536,1536,,5,1,1,2,1,1,2,10,0.273451,0.290262,0,0.002336,0.002311,0
1655,1655,,5,3,3,6,3,3,6,10,0.274074,0.291763,0,0.003693,0.003669,1
1675,1675,,5,2,2,4,2,2,4,10,0.275041,0.29263,0,0.003766,0.003735,1
6106,6106,,7,3,3,6,3,3,6,10,0.275776,0.293889,0,0.004583,0.004543,1
5794,5794,,5,2,2,4,2,2,4,10,0.269795,0.285729,0,0.002741,0.002723,1
1579,1579,,7,4,4,8,5,5,10,10,0.267024,0.285444,0,0.004409,0.004395,0.833333
1582,1582,,5,2,2,4,3,3,6,10,0.262626,0.280154,0,0.003488,0.003497,0
1584,1584,,7,1,1,2,1,1,2,10,0.259206,0.275989,0,0.001183,0.001181,0
1746,1746,,5,3,3,6,3,3,6,10,0.262865,0.280818,0,0.003779,0.003809,0.333333
2960,2960,,7,22,22,44,34,34,68,10,0.283386,0.310155,0.000067,0.015101,0.015117,0.478355
5806,5806,,5,1,1,2,1,1,2,10,0.253402,0.268987,0,0.001687,0.001684,0
1594,1594,,7,2,2,4,5,5,10,10,0.26234,0.276337,0.000669,0.00133,0.001322,0
2965,2965,,7,14,13,27,20,20,40,10,0.281013,0.304969,0.000175,0.010028,0.00995,0.604396
1605,1605,,7,1,1,2,2,2,4,11,0.207835,0.214728,0,0.000021,0.000021,0
1679,1679,,5,1,1,2,1,1,2,10,0.259836,0.275563,0,0.001801,0.001814,0
1617,1617,,26,1,2,3,2,2,4,10,0.251328,0.26763,0,0.000212,0.001528,1
1625,1625,,26,4,4,8,4,4,8,11,0.232143,0.243569,0.000084,0.000263,0.000268,0.666667
1628,1628,,26,5,5,10,6,6,12,10,0.251416,0.268207,0.000612,0.001586,0.001558,0.6
1629,1629,,26,7,7,14,9,8,17,10,0.251459,0.268554,0.000113,0.001596,0.00159,0.404762
5793,5793,,26,2,2,4,2,2,4,11,0.200933,0.209374,0,0.000029,0.00003,1
1627,1627,,26,2,2,4,2,2,4,11,0.232087,0.243165,0,0.000237,0.000242,1
1634,1634,,26,3,2,5,3,3,6,11,0.232087,0.243165,0,0.001581,0.000242,1
1639,1639,,26,2,2,4,2,2,4,11,0.232087,0.243165,0,0.000237,0.000242,1
1637,1637,,5,2,2,4,3,3,6,10,0.251044,0.267474,0,0.002025,0.002003,1
2531,2531,,34,44,44,88,90,92,182,10,0.285037,0.31422,0.006934,0.006494,0.006319,0.195169
2537,2537,,34,32,32,64,70,70,140,10,0.27766,0.30308,0.002352,0.005134,0.005073,0.311553
2578,2578,,34,33,33,66,43,43,86,10,0.268815,0.292772,0.001064,0.003706,0.003716,0.300189
2597,2597,,34,10,12,22,22,23,45,10,0.285319,0.307477,0.000385,0.003087,0.007486,0.651515
2610,2610,,34,18,20,38,42,42,84,10,0.285573,0.309906,0.001122,0.003246,0.006626,0.428947
1648,1648,,5,1,1,2,1,1,2,11,0.22386,0.235848,0,0.000379,0.000379,0
1649,1649,,5,1,1,2,1,1,2,10,0.242664,0.255876,0,0.000979,0.000979,0
1656,1656,,5,1,1,2,1,1,2,10,0.242664,0.255876,0,0.000979,0.000979,0
1659,1659,,5,1,1,2,1,1,2,10,0.242664,0.255876,0,0.000979,0.000979,0
1660,1660,,5,1,1,2,1,1,2,10,0.242664,0.255876,0,0.000979,0.000979,0
6107,6107,,5,1,1,2,1,1,2,11,0.22386,0.235848,0,0.000379,0.000379,0
5780,5780,,5,7,7,14,10,10,20,10,0.273244,0.292778,0.000001,0.004852,0.004855,0.690476
1691,1691,,5,2,2,4,2,2,4,10,0.27247,0.290699,0,0.002865,0.002867,0
1693,1693,,5,1,1,2,1,1,2,10,0.271445,0.289036,0,0.002062,0.002062,0
1694,1694,,5,1,1,2,1,1,2,10,0.271445,0.289036,0,0.002062,0.002062,0
1699,1699,,5,1,1,2,1,1,2,10,0.271445,0.289036,0,0.002062,0.002062,0
1722,1722,,5,2,2,4,2,2,4,10,0.27247,0.290699,0,0.002865,0.002867,0
1723,1723,,5,1,1,2,1,1,2,10,0.271445,0.289036,0,0.002062,0.002062,0
1724,1724,,5,1,1,2,1,1,2,10,0.271445,0.289036,0,0.002062,0.002062,0
1728,1728,,5,2,2,4,2,2,4,10,0.27247,0.290699,0,0.002865,0.002867,0
1729,1729,,5,1,1,2,1,1,2,10,0.271445,0.289036,0,0.002062,0.002062,0
2157,2157,,5,22,22,44,32,33,65,10,0.285771,0.309986,0.00204,0.008684,0.008161,0.36166
2162,2162,,5,9,9,18,17,17,34,10,0.284475,0.30629,0.000177,0.005156,0.004644,0.755556
2912,2912,,7,13,13,26,21,23,44,10,0.290693,0.316027,0.00006,0.010174,0.010179,0.692308
2992,2992,,7,15,15,30,23,22,45,10,0.280739,0.304767,0.000345,0.007959,0.007973,0.42381
3971,3971,,7,6,6,12,6,6,12,10,0.278437,0.300476,0.000025,0.005602,0.005625,0.733333
3987,3987,,5,1,1,2,1,1,2,10,0.271445,0.289036,0,0.002062,0.002062,0
4331,4331,,5,33,37,70,60,66,126,10,0.293144,0.321571,0.006294,0.010978,0.012222,0.210526
4367,4367,,7,14,16,30,20,23,43,10,0.279002,0.302486,0.000064,0.006126,0.006481,0.35
5796,5796,,5,1,1,2,1,1,2,10,0.271445,0.289036,0,0.002062,0.002062,0
5798,5798,,5,1,1,2,1,1,2,10,0.271445,0.289036,0,0.002062,0.002062,0
5799,5799,,5,1,1,2,1,1,2,10,0.271445,0.289036,0,0.002062,0.002062,0
5800,5800,,5,1,1,2,1,1,2,10,0.271445,0.289036,0,0.002062,0.002062,0
6753,6753,,5,2,2,4,2,2,4,10,0.272136,0.290122,0,0.002601,0.002597,1
6782,6782,,5,1,1,2,1,1,2,10,0.271445,0.289036,0,0.002062,0.002062,0
6783,6783,,5,1,1,2,1,1,2,10,0.271445,0.289036,0,0.002062,0.002062,0
7453,7453,,5,3,3,6,3,3,6,10,0.272496,0.290872,0,0.002943,0.002945,0.666667
1740,1740,,5,1,1,2,1,1,2,10,0.232255,0.243978,0,0.000332,0.000332,0
1753,1753,,2,1,1,2,1,1,2,11,0.228106,0.23745,0,0.000189,0.000185,0
1755,1755,,2,2,2,4,2,2,4,11,0.228142,0.237681,0,0.000192,0.000188,1
1764,1764,,2,7,7,14,9,9,18,10,0.285545,0.30418,0.000068,0.004187,0.004141,0.619048
1895,1895,,2,2,2,4,2,2,4,10,0.233005,0.243732,0,0.000294,0.000276,1
5807,5807,,2,2,3,5,2,3,5,11,0.22816,0.237854,0.000334,0.000192,0.000188,0.333333
3486,3486,,2,26,25,51,32,31,63,10,0.302929,0.326631,0.000013,0.020279,0.019835,0.804615
3678,3678,,2,51,50,101,63,62,125,10,0.303949,0.331257,0.003698,0.024826,0.024293,0.425882
5811,5811,,2,4,4,8,5,5,10,10,0.238986,0.251653,0.000002,0.000523,0.000519,0.333333
1772,1772,,2,13,13,26,15,15,30,10,0.292105,0.312831,0.000944,0.008228,0.008224,0.583333
1863,1863,,2,10,9,19,13,12,25,10,0.276014,0.296261,0.000006,0.005713,0.005323,0.711111
1771,1771,,2,8,8,16,11,11,22,11,0.229284,0.240705,0.002673,0.000475,0.000477,0.071429
1773,1773,,2,1,1,2,1,1,2,12,0.186531,0.192334,0,0.000008,0.000008,0
1774,1774,,2,4,4,8,5,5,10,10,0.270833,0.289122,0.000212,0.002351,0.002357,0.666667
1776,1776,,2,8,8,16,10,10,20,10,0.274883,0.294812,0.000385,0.004484,0.00445,0.75
4125,4125,,2,1,1,2,1,1,2,12,0.186531,0.192334,0,0.000008,0.000008,0
5832,5832,,2,1,1,2,1,1,2,12,0.186531,0.192334,0,0.000008,0.000008,0
6774,6774,,2,1,1,2,1,1,2,12,0.186531,0.192334,0,0.000008,0.000008,0
1957,1957,,2,13,14,27,16,16,32,10,0.286281,0.307094,0.004006,0.007726,0.007931,0.461538
1782,1782,,2,1,1,2,1,1,2,11,0.242991,0.254839,0,0.000527,0.000466,0
3544,3544,,2,7,7,14,7,7,14,10,0.268966,0.287856,0.000001,0.004193,0.00416,0.619048
7302,7302,,2,1,1,2,1,1,2,11,0.242991,0.254839,0,0.000527,0.000466,0
1783,1783,,2,6,6,12,10,10,20,10,0.270453,0.28735,0.000008,0.002329,0.002334,0.6
1825,1825,,2,29,29,58,39,39,78,10,0.284335,0.307296,0.00057,0.006465,0.006521,0.225369
1847,1847,,2,21,22,43,32,33,65,10,0.286082,0.307699,0.001982,0.002889,0.003965,0.166667
1850,1850,,2,10,10,20,13,13,26,10,0.277794,0.295129,0.000022,0.003039,0.003035,0.466667
1785,1785,,2,2,2,4,2,2,4,10,0.257219,0.27134,0,0.000733,0.000733,1
1786,1786,,2,2,2,4,4,4,8,10,0.27247,0.288718,0,0.002003,0.002017,1
1787,1787,,2,1,1,2,1,1,2,11,0.222462,0.23188,0,0.000064,0.000046,0
1789,1789,,2,3,3,6,3,3,6,10,0.252096,0.266238,0,0.000729,0.000746,1
1819,1819,,2,8,8,16,11,11,22,10,0.267867,0.285127,0.000019,0.00267,0.002701,0.642857
1853,1853,,2,6,6,12,9,9,18,10,0.252383,0.267277,0.000001,0.001015,0.001029,0.6
1792,1792,,2,7,7,14,12,12,24,10,0.259602,0.274489,0.000002,0.001298,0.001295,0.809524
1804,1804,,2,30,30,60,49,49,98,10,0.294791,0.318587,0.000684,0.010783,0.010831,0.302299
1816,1816,,2,6,6,12,7,7,14,10,0.259977,0.274616,0,0.001142,0.00114,0.866667
1820,1820,,2,4,4,8,5,5,10,10,0.252317,0.266873,0,0.000969,0.000984,1
1793,1793,,2,1,1,2,1,1,2,10,0.25203,0.265834,0,0.00067,0.000687,0
1794,1794,,2,3,3,6,3,3,6,10,0.252295,0.2667,0,0.000948,0.000963,1
1796,1796,,2,3,3,6,5,5,10,10,0.252295,0.2667,0,0.000948,0.000963,1
1797,1797,,2,3,3,6,5,5,10,10,0.252295,0.2667,0,0.000948,0.000963,1
1798,1798,,2,2,2,4,2,2,4,10,0.252074,0.266065,0.000669,0.00067,0.000687,0
1818,1818,,2,1,1,2,1,1,2,11,0.201339,0.208272,0,0.000011,0.000011,0
1801,1801,,2,1,1,2,1,1,2,10,0.25203,0.265834,0,0.00067,0.000687,0
1802,1802,,2,1,1,2,1,1,2,10,0.25203,0.265834,0,0.00067,0.000687,0
1807,1807,,2,6,5,11,13,12,25,10,0.264237,0.280069,0.000006,0.002818,0.001637,0.8
1854,1854,,2,5,5,10,8,8,16,10,0.259416,0.276095,0.000478,0.00178,0.001804,0.6
3453,3453,,2,29,29,58,33,33,66,10,0.300844,0.323934,0.00012,0.011121,0.011095,0.433498
3687,3687,,2,3,3,6,4,4,8,10,0.26361,0.280524,0,0.001833,0.001849,1
3734,3734,,2,15,15,30,17,17,34,10,0.283024,0.304957,0.001309,0.007504,0.007524,0.628571
3748,3748,,2,26,26,52,32,32,64,10,0.302262,0.325909,0.000061,0.014784,0.014792,0.621538
3817,3817,,2,23,23,46,27,27,54,10,0.302579,0.325419,0.000044,0.014623,0.014638,0.701581
1808,1808,,2,1,1,2,1,1,2,10,0.25203,0.265834,0,0.00067,0.000687,0
1810,1810,,2,2,2,4,2,2,4,10,0.252074,0.266065,0.000669,0.00067,0.000687,0
1834,1834,,2,1,1,2,1,1,2,11,0.201339,0.208272,0,0.000011,0.000011,0
1813,1813,,2,1,1,2,1,1,2,10,0.25203,0.265834,0,0.00067,0.000687,0
1814,1814,,2,3,3,6,4,4,8,10,0.257242,0.271513,0,0.000838,0.000837,1
1815,1815,,2,4,4,8,6,6,12,10,0.277473,0.294103,0.000006,0.002158,0.002156,0.666667
1821,1821,,2,4,4,8,5,5,10,10,0.274962,0.291419,0.000004,0.002015,0.002022,0.833333
1829,1829,,2,3,3,6,5,5,10,10,0.257242,0.271513,0,0.000838,0.000837,1
1830,1830,,2,3,3,6,3,3,6,10,0.252096,0.266238,0.00019,0.000687,0.000704,0.333333
1837,1837,,2,1,1,2,1,1,2,10,0.25203,0.265834,0,0.00067,0.000687,0
1842,1842,,2,2,2,4,2,2,4,10,0.252427,0.266787,0,0.000979,0.000995,1
1845,1845,,2,1,1,2,2,2,4,10,0.25203,0.265834,0,0.00067,0.000687,0
1846,1846,,2,2,2,4,5,5,10,10,0.252096,0.266122,0,0.000774,0.00079,1
1848,1848,,2,2,2,4,3,3,6,10,0.252096,0.266122,0,0.000774,0.00079,1
1851,1851,,2,1,1,2,1,1,2,10,0.25203,0.265834,0,0.00067,0.000687,0
1858,1858,,2,3,3,6,3,3,6,10,0.278222,0.294413,0,0.002475,0.002499,1
3621,3621,,2,28,28,56,31,31,62,10,0.303119,0.327642,0.000341,0.019234,0.019263,0.624339
5837,5837,,2,1,1,2,1,1,2,10,0.25203,0.265834,0,0.00067,0.000687,0
5854,5854,,2,1,1,2,1,1,2,10,0.25203,0.265834,0,0.00067,0.000687,0
1839,1839,,2,2,2,4,2,2,4,11,0.20604,0.214271,0,0.00004,0.00004,0
1831,1831,,2,2,2,4,2,2,4,10,0.258579,0.2731,0.000003,0.000895,0.000886,0
1835,1835,,2,1,1,2,1,1,2,11,0.222462,0.23188,0,0.000064,0.000046,0
1855,1855,,2,2,2,4,2,2,4,10,0.272444,0.287568,0.000004,0.00124,0.001232,0
3458,3458,,2,32,32,64,39,39,78,10,0.295424,0.320256,0.001179,0.0162,0.016283,0.563508
3585,3585,,2,24,20,44,31,27,58,10,0.291339,0.314314,0.000011,0.014735,0.012864,0.789855
3673,3673,,2,31,31,62,38,38,76,10,0.304495,0.328774,0.000355,0.020287,0.020336,0.597849
3717,3717,,2,25,24,49,42,40,82,10,0.29464,0.318428,0.00063,0.014878,0.014951,0.656667
3759,3759,,2,19,23,42,22,26,48,10,0.300281,0.324009,0.000004,0.013499,0.016624,0.865613
3825,3825,,2,21,21,42,28,27,55,10,0.290722,0.314962,0.000009,0.014897,0.01493,0.8
1865,1865,,27,2,2,4,3,3,6,12,0.186712,0.193479,0.003005,0.000003,0.000003,0
1869,1869,,27,4,5,9,7,9,16,13,0.157412,0.162222,0.002339,0,0,0
5848,5848,,27,11,11,22,11,11,22,11,0.229375,0.241924,0.004742,0.000211,0.00021,0.075758
1867,1867,,27,1,1,2,2,2,4,14,0.13601,0.138899,0,0,0,0
5955,5955,,27,1,0,1,1,0,1,0,0,0,0,0,0,0
5957,5957,,27,1,1,2,2,2,4,14,0.13601,0.138899,0,0,0,0
7895,7895,,27,1,0,1,2,0,2,0,0,0,0,0,0,0
2551,2551,,34,20,21,41,36,38,74,10,0.269972,0.291829,0.007657,0.003037,0.003184,0.166667
2673,2673,,2,14,15,29,23,24,47,10,0.295848,0.320205,0.001886,0.006332,0.00876,0.441667
2710,2710,,2,5,5,10,6,6,12,10,0.261887,0.279491,0.000043,0.002033,0.002031,0.7
2714,2714,,2,8,8,16,9,9,18,10,0.263803,0.283178,0.000048,0.002793,0.002802,0.571429
2749,2749,,2,4,4,8,5,5,10,10,0.250608,0.265216,0.000669,0.000885,0.000887,0.5
2848,2848,,2,6,6,12,10,10,20,10,0.26234,0.279525,0.000013,0.002293,0.002257,0.666667
2868,2868,,2,7,7,14,11,11,22,10,0.252405,0.268294,0.000012,0.001513,0.001485,0.571429
1879,1879,,27,3,3,6,3,3,6,11,0.23869,0.250725,0.000042,0.000342,0.000342,0.666667
5847,5847,,27,3,4,7,3,4,7,11,0.23871,0.250898,0.000042,0.000342,0.000348,0.666667
5844,5844,,2,3,3,6,3,3,6,11,0.240922,0.253517,0.000042,0.000511,0.000511,0.666667
1884,1884,,27,3,2,5,3,2,5,12,0.19437,0.201417,0.000258,0.000344,0.000003,0.5
5845,5845,,27,2,2,4,2,2,4,11,0.238512,0.25028,0.000254,0.000003,0.000339,0.333333
1887,1887,,27,2,2,4,2,2,4,11,0.238512,0.25028,0,0.000339,0.000339,1
1889,1889,,27,5,4,9,5,4,9,11,0.23871,0.250898,0.000512,0.000348,0.000342,0.4
6732,6732,,27,2,3,5,2,3,5,11,0.23869,0.250725,0.000043,0.000337,0.000342,0.333333
6945,6945,,27,2,2,4,2,2,4,11,0.23867,0.250552,0.000042,0.000337,0.000337,0
6731,6731,,27,2,2,4,2,2,4,12,0.19437,0.201417,0,0.000009,0.000009,1
1898,1898,,2,2,1,3,2,1,3,10,0.243503,0.256265,0,0.000606,0.00039,1
1899,1899,,2,1,1,2,1,1,2,10,0.243503,0.256265,0,0.000404,0.00039,0
1908,1908,,2,1,1,2,1,1,2,10,0.243503,0.256265,0,0.000404,0.00039,0
1912,1912,,2,1,1,2,1,1,2,11,0.231528,0.241889,0,0.000404,0.000223,1
1913,1913,,2,1,1,2,1,1,2,10,0.243503,0.256265,0,0.000404,0.00039,0
1914,1914,,2,1,1,2,1,1,2,10,0.243503,0.256265,0,0.000404,0.00039,0
1925,1925,,2,3,2,5,3,2,5,11,0.228431,0.238176,0.000019,0.001307,0.000239,0.666667
4314,4314,,2,2,2,4,2,2,4,11,0.228431,0.238176,0,0.000237,0.000256,1
1930,1930,,2,3,3,6,4,4,8,11,0.233911,0.245537,0.000001,0.000531,0.000531,0.333333
1934,1934,,2,2,2,4,2,2,4,11,0.233609,0.2447,0,0.000302,0.000301,1
1932,1932,,2,2,2,4,2,2,4,11,0.23359,0.244642,0,0.000298,0.000298,1
5859,5859,,2,2,2,4,2,2,4,11,0.23359,0.244642,0,0.000298,0.000298,1
1935,1935,,2,0,1,1,0,1,1,11,0.244952,0.259078,0,0,0.000617,0
1937,1937,,2,1,1,2,1,1,2,11,0.233571,0.244469,0,0.000293,0.000293,0
1946,1946,,2,2,2,4,3,3,6,11,0.23359,0.244642,0,0.000319,0.000319,1
1943,1943,,2,1,2,3,2,2,4,11,0.23359,0.244642,0,0.000293,0.000298,1
1944,1944,,2,2,1,3,2,2,4,11,0.233571,0.244469,0,0.000298,0.000293,1
1949,1949,,2,2,2,4,2,2,4,11,0.23359,0.244642,0,0.000298,0.000298,1
1952,1952,,2,2,2,4,2,2,4,11,0.23359,0.244642,0,0.000298,0.000298,1
1950,1950,,2,2,1,3,3,2,5,11,0.233571,0.244469,0,0.000308,0.000293,1
1951,1951,,2,1,1,2,2,2,4,11,0.233571,0.244469,0,0.000293,0.000293,0
1956,1956,,2,2,3,5,2,3,5,11,0.247089,0.262344,0.000005,0.00091,0.000914,0.666667
5857,5857,,2,1,1,2,1,2,3,11,0.233571,0.244469,0,0.000293,0.000293,0
4279,4279,,2,3,3,6,4,5,9,11,0.222634,0.232211,0.000669,0.000129,0.000126,0.333333
6463,6463,,2,3,3,6,5,5,10,11,0.222634,0.232211,0,0.000131,0.000128,0.666667
7287,7287,,2,3,3,6,6,6,12,11,0.222634,0.232211,0,0.000131,0.000128,0.666667
7288,7288,,2,3,3,6,4,4,8,11,0.222634,0.232211,0.000669,0.000129,0.000126,0.333333
1958,1958,,28,2,2,4,2,2,4,11,0.215986,0.224075,0,0.000024,0.000024,1
1959,1959,,28,8,8,16,8,8,16,10,0.275434,0.292621,0.00334,0.001456,0.001474,0.142857
5861,5861,,28,2,2,4,2,2,4,11,0.215986,0.224075,0,0.000024,0.000024,1
4075,4075,,28,27,27,54,29,29,58,10,0.288024,0.308855,0.017178,0.002889,0.00287,0.068966
5862,5862,,28,1,1,2,1,1,2,11,0.215969,0.223902,0,0.000024,0.000023,0
5864,5864,,28,1,1,2,1,1,2,11,0.215969,0.223902,0,0.000024,0.000023,0
5865,5865,,28,1,1,2,1,1,2,11,0.215969,0.223902,0,0.000024,0.000023,0
1960,1960,,30,18,18,36,23,23,46,10,0.295334,0.318292,0.005968,0.004872,0.004852,0.313726
1963,1963,,30,3,3,6,3,3,6,10,0.24468,0.256224,0.000004,0.000313,0.000322,0.666667
1965,1965,,0,2,2,4,3,3,6,11,0.228052,0.238139,0.000055,0.000081,0.000078,0
1968,1968,,30,3,3,6,3,3,6,11,0.229466,0.239926,0.000669,0.000134,0.000136,0.333333
1969,1969,,30,3,3,6,3,3,6,10,0.256419,0.269681,0,0.00061,0.000619,1
1997,1997,,30,21,20,41,23,22,45,10,0.255965,0.27497,0.011923,0.001151,0.001162,0.106061
2005,2005,,30,10,10,20,14,15,29,10,0.28236,0.302941,0.000993,0.003574,0.003525,0.488889
2009,2009,,30,11,11,22,19,19,38,10,0.27718,0.298124,0.000106,0.002947,0.002958,0.6
2246,2246,,30,17,18,35,23,24,47,10,0.285686,0.307667,0.002671,0.005866,0.005761,0.323529
2252,2252,,2,2,2,4,2,2,4,11,0.246351,0.258776,0,0.000379,0.000379,1
1961,1961,,30,3,3,6,3,3,6,10,0.244018,0.255179,0.000669,0.000236,0.000245,0.333333
4077,4077,,30,1,1,2,1,1,2,11,0.196166,0.201844,0,0.000004,0.000004,0
4076,4076,,0,2,2,4,2,2,4,11,0.244224,0.256744,0.000011,0.000007,0.000196,0.333333
5885,5885,,30,1,1,2,1,1,2,12,0.186651,0.192166,0,0.000002,0.000002,0
1970,1970,,2,1,1,2,1,1,2,11,0.244018,0.255563,0,0.000301,0.000301,0
1971,1971,,28,3,3,6,3,3,6,11,0.223669,0.232896,0,0.000048,0.000048,0.666667
1972,1972,,28,3,3,6,3,3,6,11,0.223669,0.232896,0,0.000048,0.000048,0.666667
6926,6926,,28,2,2,4,2,2,4,11,0.223652,0.232723,0,0.000047,0.000047,1
7456,7456,,28,2,2,4,2,2,4,11,0.223652,0.232723,0,0.000047,0.000047,1
1975,1975,,28,4,2,6,4,2,6,11,0.223669,0.232781,0,0.000048,0.000047,0.666667
1990,1990,,28,6,5,11,6,5,11,11,0.223721,0.2333,0.000112,0.00005,0.000049,0.433333
1977,1977,,28,3,3,6,3,3,6,11,0.223686,0.232954,0.000111,0.000048,0.000047,0.833333
1978,1978,,28,3,4,7,3,4,7,11,0.223704,0.233127,0.000167,0.000002,0.000049,0.55
1979,1979,,28,1,1,2,1,1,2,11,0.223652,0.232607,0.000334,0,0.000046,0.5
1981,1981,,28,2,2,4,2,2,4,11,0.223652,0.232723,0,0.000047,0.000047,1
1993,1993,,28,2,2,4,2,2,4,11,0.223652,0.232723,0,0.000047,0.000047,1
1983,1983,,28,0,1,1,0,1,1,12,0.182814,0.187704,0,0,0.000001,0
1986,1986,,28,3,1,4,3,1,4,11,0.223634,0.23255,0.000501,0.000046,0.000046,0.166667
1984,1984,,28,1,1,2,1,1,2,11,0.223634,0.23255,0,0.000046,0.000046,0
1985,1985,,28,2,2,4,2,2,4,11,0.223669,0.232781,0,0.000047,0.000047,1
1987,1987,,28,4,4,8,4,4,8,11,0.223721,0.233185,0.000668,0.000047,0.000047,0.666667
5890,5890,,28,4,4,8,4,4,8,11,0.223721,0.233185,0.000668,0.000047,0.000047,0.666667
5891,5891,,28,3,3,6,3,3,6,12,0.182855,0.188173,0,0.000002,0.000002,1
5892,5892,,28,3,3,6,3,3,6,12,0.182855,0.188173,0,0.000002,0.000002,1
1989,1989,,28,5,6,11,5,6,11,11,0.223756,0.233531,0.000335,0.000048,0.00005,0.452381
1991,1991,,28,4,4,8,4,4,8,11,0.223704,0.233127,0,0.000048,0.000049,0.833333
1994,1994,,28,2,2,4,2,2,4,12,0.182867,0.188115,0,0.000002,0.000002,1
1995,1995,,28,5,4,9,5,4,9,11,0.223704,0.233127,0.000334,0.000048,0.000048,0.65
1992,1992,,28,2,4,6,2,4,6,11,0.223704,0.233127,0,0.000047,0.000049,1
4242,4242,,47,4,4,8,4,4,8,11,0.203914,0.21319,0.002005,0.000019,0.000019,0.15
5896,5896,,30,1,1,2,1,1,2,11,0.203814,0.212468,0,0.000019,0.000018,0
5897,5897,,30,4,3,7,4,3,7,12,0.169505,0.175177,0.000168,0.000019,0.000001,0.333333
5900,5900,,30,2,2,4,2,2,4,11,0.203842,0.212699,0.0005,0.000019,0.000018,0
5901,5901,,30,2,2,4,2,2,4,11,0.203842,0.212699,0,0.000019,0.000019,1
5902,5902,,30,2,2,4,2,2,4,11,0.203842,0.212699,0.000155,0.000019,0.000019,0.5
5904,5904,,46,2,2,4,2,2,4,11,0.2039,0.212901,0.000027,0.000019,0.000019,0
5905,5905,,30,4,5,9,4,5,9,11,0.204015,0.213652,0.000516,0.000022,0.000023,0.3
5908,5908,,46,9,8,17,9,8,17,11,0.244908,0.2591,0.005163,0.000213,0.000213,0.152778
5909,5909,,30,1,1,2,1,1,2,11,0.203814,0.212468,0,0.000019,0.000018,0
5911,5911,,30,1,1,2,1,1,2,11,0.203814,0.212468,0,0.000019,0.000018,0
5916,5916,,47,2,2,4,2,2,4,11,0.203828,0.212641,0,0.000019,0.000019,1
5918,5918,,47,3,3,6,3,3,6,11,0.203886,0.212959,0,0.000019,0.000019,0.666667
1998,1998,,29,1,1,2,1,1,2,2,0.545455,0.583333,0,0,0,0
2001,2001,,29,7,6,13,7,6,13,1,1,1,0.000005,0,0,0.047619
1999,1999,,29,1,2,3,1,2,3,2,0.571429,0.625,0.000001,0,0,0
5920,5920,,29,1,1,2,1,1,2,3,0.380952,0.4375,0,0,0,0
2000,2000,,29,2,2,4,2,2,4,2,0.6,0.666667,0,0,0,1
5919,5919,,29,2,2,4,2,2,4,2,0.6,0.666667,0,0,0,1
2002,2002,,29,1,1,2,1,1,2,2,0.545455,0.583333,0,0,0,0
2004,2004,,29,1,1,2,1,1,2,2,0.545455,0.583333,0,0,0,0
5921,5921,,29,1,1,2,1,1,2,2,0.545455,0.583333,0,0,0,0
2011,2011,,30,3,3,6,3,3,6,10,0.243997,0.255121,0,0.000296,0.000305,1
2030,2030,,30,5,5,10,9,9,18,10,0.253291,0.267965,0,0.000915,0.000925,1
2042,2042,,30,6,6,12,8,8,16,10,0.254184,0.269345,0.000013,0.001055,0.001065,0.8
3272,3272,,30,17,17,34,22,22,44,10,0.303183,0.330798,0.000225,0.009845,0.009777,0.617647
3321,3321,,30,17,17,34,24,24,48,10,0.285065,0.306961,0.000707,0.003631,0.003642,0.404412
3341,3341,,30,25,24,49,39,39,78,10,0.278303,0.301936,0.005426,0.004258,0.003205,0.226667
3359,3359,,30,5,4,9,5,4,9,10,0.254139,0.268998,0.000001,0.001017,0.001013,0.9
5884,5884,,30,1,1,2,1,1,2,10,0.243956,0.254775,0,0.000231,0.00024,0
2031,2031,,30,1,1,2,1,1,2,10,0.250608,0.26387,0,0.000325,0.000326,0
2048,2048,,7,6,6,12,9,9,18,11,0.234234,0.246521,0.000943,0.000287,0.000319,0.266667
2051,2051,,7,6,5,11,8,7,15,10,0.281946,0.301249,0.000291,0.003864,0.003693,0.6
2052,2052,,7,2,2,4,2,2,4,11,0.192195,0.199331,0,0.000012,0.000011,1
2053,2053,,7,4,4,8,5,5,10,10,0.237824,0.251251,0.000401,0.000418,0.000427,0.5
7500,7500,,7,1,1,2,2,2,4,12,0.189794,0.196115,0,0.000005,0.000005,0
7501,7501,,7,2,2,4,4,4,8,11,0.234101,0.245712,0,0.000222,0.000251,1
2056,2056,,7,1,1,2,1,1,2,11,0.234044,0.245424,0,0.000217,0.000246,0
2219,2219,,30,18,18,36,28,29,57,10,0.288369,0.311938,0.000847,0.010075,0.010047,0.565359
3399,3399,,30,44,44,88,92,91,183,10,0.287593,0.31741,0.007113,0.01117,0.011298,0.19186
5922,5922,,7,1,1,2,1,1,2,11,0.234044,0.245424,0,0.000217,0.000246,0
7499,7499,,7,1,1,2,1,1,2,11,0.234044,0.245424,0,0.000217,0.000246,0
2234,2234,,5,6,6,12,7,7,14,10,0.282636,0.30084,0,0.00491,0.004639,0.809524
3076,3076,,30,27,27,54,66,71,137,10,0.298387,0.327379,0.001394,0.015855,0.016276,0.486772
3125,3125,,30,34,35,69,54,55,109,10,0.301473,0.330722,0.008649,0.014567,0.014898,0.221849
3136,3136,,30,22,20,42,47,49,96,10,0.290342,0.314883,0.000244,0.012735,0.012692,0.647186
3137,3137,,30,14,17,31,26,29,55,10,0.28308,0.304869,0.000066,0.008618,0.008739,0.536765
3143,3143,,30,6,7,13,9,10,19,10,0.281836,0.301318,0,0.004681,0.006404,0.888889
3153,3153,,30,17,17,34,35,34,69,10,0.287794,0.310806,0.000055,0.01114,0.010417,0.748366
4150,4150,,5,15,16,31,25,26,51,10,0.281616,0.302842,0.000989,0.004399,0.004625,0.458333
7490,7490,,30,9,9,18,12,12,24,10,0.282443,0.302404,0.000135,0.004868,0.004766,0.486111
2086,2086,,30,5,5,10,5,5,10,10,0.25338,0.269836,0,0.00159,0.001567,0.9
2089,2089,,30,11,11,22,11,11,22,10,0.25396,0.271424,0.000007,0.002276,0.002328,0.527273
2090,2090,,30,9,9,18,9,9,18,10,0.253915,0.271077,0,0.0022,0.002254,0.777778
2060,2060,,30,1,1,2,1,1,2,10,0.25076,0.265811,0,0.000741,0.000724,0
2061,2061,,30,3,3,6,3,3,6,10,0.253781,0.270038,0,0.001817,0.001798,1
2062,2062,,30,2,2,4,2,2,4,10,0.253313,0.269316,0,0.001434,0.001414,1
2066,2066,,30,8,8,16,9,9,18,10,0.253893,0.270904,0,0.002117,0.002171,0.785714
2075,2075,,30,5,5,10,5,5,10,10,0.253826,0.270384,0,0.001888,0.001867,1
6776,6776,,30,9,8,17,11,10,21,10,0.261911,0.281016,0,0.004354,0.003854,0.944444
2068,2068,,30,2,2,4,2,2,4,10,0.253313,0.269316,0,0.001434,0.001414,1
2069,2069,,30,5,5,10,5,5,10,10,0.25338,0.269836,0,0.001656,0.00171,0.8
2076,2076,,30,3,3,6,3,3,6,10,0.253336,0.269489,0,0.001462,0.001441,1
2084,2084,,30,4,4,8,4,4,8,10,0.253358,0.269663,0,0.001633,0.001687,1
2081,2081,,30,3,3,6,3,3,6,10,0.253336,0.269489,0.000003,0.001446,0.001427,0.666667
2095,2095,,30,3,3,6,3,3,6,10,0.250826,0.266215,0,0.00095,0.001006,1
2104,2104,,5,12,12,24,25,25,50,10,0.28236,0.302692,0.000158,0.004596,0.00402,0.647436
2123,2123,,5,8,7,15,11,10,21,11,0.227603,0.241552,0.000033,0.001267,0.000521,0.642857
2131,2131,,5,39,40,79,96,96,192,10,0.254408,0.277158,0.007473,0.001949,0.002249,0.085256
2164,2164,,5,4,3,7,8,7,15,11,0.227316,0.240437,0,0.001035,0.000268,0.75
2167,2167,,5,7,6,13,11,10,21,11,0.227782,0.241841,0.00003,0.001076,0.000311,0.404762
2171,2171,,30,4,4,8,4,4,8,10,0.265379,0.283045,0.000001,0.002,0.002058,0.416667
3069,3069,,30,10,10,20,17,17,34,10,0.287995,0.310171,0.000221,0.006215,0.006153,0.5
3074,3074,,30,3,2,5,5,4,9,10,0.279218,0.296577,0,0.002791,0.002039,1
3275,3275,,30,53,54,107,133,138,271,10,0.312608,0.34538,0.012598,0.019024,0.019145,0.187631
5924,5924,,30,2,2,4,2,2,4,10,0.253313,0.269316,0,0.001434,0.001414,1
5925,5925,,30,3,3,6,3,3,6,10,0.253336,0.269489,0,0.001472,0.001451,1
5933,5933,,5,4,3,7,5,4,9,11,0.227316,0.240437,0,0.001035,0.000268,0.75
5936,5936,,30,2,1,3,4,3,7,11,0.202825,0.212782,0,0.000778,0.000031,1
5954,5954,,30,4,4,8,5,5,10,10,0.265453,0.283218,0,0.002139,0.002098,0.75
2093,2093,,30,3,3,6,3,3,6,10,0.25039,0.264829,0,0.000753,0.000751,0.666667
3105,3105,,30,8,9,17,16,15,31,10,0.282692,0.30353,0.000031,0.005407,0.005403,0.638889
2097,2097,,5,4,4,8,6,6,12,11,0.227549,0.241032,0,0.000437,0.000417,1
2103,2103,,5,3,3,6,5,5,10,11,0.227316,0.240437,0,0.000306,0.000278,1
2109,2109,,5,8,7,15,17,16,33,10,0.280303,0.299175,0.00012,0.00236,0.00218,0.892857
2134,2134,,5,14,14,28,22,21,43,10,0.281259,0.301445,0.000509,0.003767,0.0038,0.467033
2106,2106,,5,3,3,6,4,4,8,10,0.280194,0.298482,0.000087,0.001956,0.001955,0.666667
2110,2110,,5,1,1,2,1,1,2,11,0.222274,0.232849,0,0.000131,0.000139,0
2114,2114,,5,5,5,10,9,8,17,11,0.227352,0.240784,0.000005,0.000302,0.000277,0.6
2136,2136,,5,6,6,12,8,9,17,11,0.227638,0.241494,0.000001,0.000447,0.00044,0.666667
7546,7546,,5,4,4,8,4,4,8,11,0.220255,0.231319,0,0.000123,0.000127,0.5
2117,2117,,5,1,1,2,2,2,4,11,0.202825,0.212782,0,0.000036,0.000031,0
2142,2142,,5,2,2,4,2,2,4,11,0.227298,0.240264,0,0.000232,0.000207,1
2151,2151,,5,1,1,2,1,1,2,11,0.202825,0.212782,0,0.000036,0.000031,0
2166,2166,,5,6,6,12,7,7,14,10,0.280494,0.299406,0.00015,0.002608,0.002587,0.533333
5712,5712,,5,2,2,4,4,4,8,11,0.223012,0.234986,0,0.000167,0.000171,1
5927,5927,,5,1,1,2,1,1,2,11,0.202825,0.212782,0,0.000036,0.000031,0
5928,5928,,5,1,1,2,1,1,2,11,0.202825,0.212782,0,0.000036,0.000031,0
5930,5930,,5,1,1,2,1,1,2,11,0.202825,0.212782,0,0.000036,0.000031,0
5931,5931,,5,1,1,2,1,1,2,11,0.202825,0.212782,0,0.000036,0.000031,0
5932,5932,,5,2,2,4,2,2,4,11,0.227298,0.240264,0,0.000232,0.000207,1
5934,5934,,30,5,5,10,5,5,10,10,0.281204,0.300232,0.000127,0.003896,0.003894,0.7
5935,5935,,5,2,2,4,4,4,8,11,0.227298,0.240264,0,0.000232,0.000207,1
6746,6746,,5,1,1,2,1,1,2,11,0.202825,0.212782,0,0.000036,0.000031,0
6747,6747,,5,3,3,6,5,5,10,11,0.227405,0.240599,0,0.000237,0.000225,1
6748,6748,,5,1,1,2,1,1,2,11,0.202825,0.212782,0,0.000036,0.000031,0
6749,6749,,5,1,1,2,1,1,2,11,0.202825,0.212782,0,0.000036,0.000031,0
6759,6759,,30,2,2,4,3,3,6,10,0.246835,0.261261,0.000002,0.000672,0.000666,0
7547,7547,,5,1,1,2,1,1,2,11,0.202825,0.212782,0,0.000036,0.000031,0
2221,2221,,30,9,9,18,9,9,18,10,0.280739,0.299799,0.000331,0.003176,0.003149,0.366667
2172,2172,,5,1,2,3,1,2,3,10,0.285178,0.303959,0,0.001079,0.003694,1
5937,5937,,30,4,4,8,5,5,10,10,0.25844,0.274079,0.000001,0.001901,0.00194,0.5
2237,2237,,30,2,2,4,2,2,4,10,0.253047,0.268262,0,0.00145,0.001371,1
2994,2994,,30,14,13,27,29,28,57,10,0.287823,0.310275,0.000013,0.008394,0.007782,0.714286
2202,2202,,30,5,5,10,5,5,10,10,0.279678,0.297732,0.000028,0.003245,0.00221,0.5
3081,3081,,30,10,9,19,11,10,21,10,0.284223,0.305152,0.000002,0.0083,0.007246,0.633333
3152,3152,,30,6,6,12,9,9,18,10,0.287307,0.307919,0,0.005432,0.005421,1
2214,2214,,30,8,7,15,8,7,15,10,0.280303,0.298933,0.000187,0.003214,0.003156,0.607143
3017,3017,,30,8,8,16,15,15,30,10,0.281479,0.300989,0.000005,0.004772,0.0048,0.857143
3098,3098,,30,8,7,15,13,12,25,10,0.281341,0.300792,0.000015,0.004044,0.004032,0.607143
3382,3382,,30,69,69,138,152,151,303,10,0.306728,0.340316,0.009923,0.018276,0.018299,0.253623
5942,5942,,30,4,4,8,4,4,8,10,0.279705,0.297674,0,0.003078,0.002648,1
2229,2229,,30,1,1,2,1,1,2,11,0.225082,0.238467,0,0.000353,0.000333,0
3015,3015,,30,9,8,17,14,13,27,10,0.262054,0.280227,0.000015,0.002849,0.002823,0.472222
3135,3135,,30,7,7,14,10,10,20,10,0.274178,0.294391,0.000004,0.003906,0.003892,0.714286
5951,5951,,30,6,6,12,6,6,12,10,0.24845,0.264475,0.000339,0.001319,0.001255,0.428571
2192,2192,,30,1,1,2,1,1,2,10,0.242094,0.255398,0,0.000521,0.000517,0
2195,2195,,30,4,3,7,4,3,7,10,0.243318,0.257194,0,0.000916,0.00081,0.6
2203,2203,,30,4,4,8,4,4,8,10,0.246751,0.261396,0.000001,0.000921,0.000928,0.7
2222,2222,,30,3,3,6,3,3,6,10,0.263489,0.279557,0,0.000833,0.001822,0.75
5939,5939,,30,4,4,8,4,4,8,10,0.250325,0.265192,0,0.001325,0.001318,0.666667
2204,2204,,30,2,2,4,2,2,4,10,0.245346,0.258106,0,0.0005,0.000462,1
5949,5949,,30,2,2,4,2,2,4,10,0.245346,0.258106,0,0.0005,0.000462,1
2212,2212,,30,2,2,4,2,2,4,10,0.242501,0.254952,0,0.000395,0.00036,1
2217,2217,,30,2,3,5,2,3,5,10,0.242521,0.255125,0,0.000425,0.000375,0.916667
2227,2227,,30,5,5,10,5,5,10,10,0.250347,0.265366,0.000014,0.001303,0.00128,0.5
2215,2215,,30,2,2,4,2,2,4,10,0.24338,0.25552,0,0.000431,0.000481,1
5945,5945,,30,3,3,6,3,3,6,10,0.243421,0.255751,0,0.000452,0.000501,0.666667
2233,2233,,30,3,4,7,3,4,7,10,0.242623,0.255471,0.000008,0.000104,0.000444,0.5
5940,5940,,30,2,2,4,2,2,4,10,0.246435,0.259492,0,0.000654,0.000616,1
5943,5943,,30,2,2,4,2,2,4,11,0.223912,0.234553,0.000002,0.000168,0.000163,0
5953,5953,,5,1,1,2,1,1,2,10,0.244369,0.258065,0,0.000814,0.000736,0
4206,4206,,30,25,25,50,45,45,90,10,0.291221,0.314488,0.001332,0.006375,0.006269,0.14
2243,2243,,30,2,2,4,2,2,4,11,0.222308,0.232279,0.000001,0.000129,0.000132,0
2244,2244,,30,5,5,10,5,5,10,10,0.27397,0.29112,0.000846,0.002361,0.002287,0.3
2247,2247,,30,1,1,2,1,1,2,11,0.215068,0.223152,0,0.000037,0.000038,0
2372,2372,,30,27,27,54,52,54,106,10,0.29461,0.32032,0.000253,0.01197,0.011913,0.467236
2249,2249,,31,3,2,5,3,2,5,11,0.244142,0.255968,0.001253,0.000393,0.000301,0.333333
2254,2254,,31,2,2,4,2,2,4,11,0.222308,0.232279,0.00075,0.000092,0.000094,0
2256,2256,,30,5,5,10,6,6,12,10,0.277074,0.294055,0.000207,0.002855,0.002756,0.7
2258,2258,,30,2,2,4,2,2,4,11,0.222239,0.232077,0,0.000137,0.00014,1
2287,2287,,30,26,26,52,40,39,79,10,0.286026,0.310058,0.00083,0.008239,0.008165,0.307692
2305,2305,,30,26,26,52,39,39,78,10,0.29422,0.32058,0.001816,0.010375,0.010243,0.389231
4381,4381,,30,5,5,10,5,5,10,10,0.271751,0.290266,0.000004,0.002463,0.002427,0.7
2251,2251,,31,3,3,6,3,3,6,12,0.196327,0.202812,0.000587,0.000005,0.000006,0.333333
2255,2255,,31,3,3,6,3,3,6,12,0.181944,0.187797,0.000132,0.000002,0.000002,0.333333
2257,2257,,31,2,2,4,2,2,4,13,0.164848,0.168914,0,0,0,1
2259,2259,,30,2,2,4,6,6,12,11,0.225293,0.236932,0,0.000212,0.000213,1
2264,2264,,30,22,22,44,35,35,70,10,0.289556,0.314434,0.001768,0.009814,0.009753,0.458874
2275,2275,,30,16,16,32,36,36,72,10,0.265136,0.286679,0.000961,0.003461,0.00345,0.391667
2262,2262,,30,1,1,2,2,2,4,11,0.209586,0.219393,0,0.000055,0.000056,0
2272,2272,,30,2,2,4,6,6,12,11,0.225293,0.236932,0,0.000212,0.000213,1
2278,2278,,30,2,2,4,2,2,4,11,0.225293,0.236932,0,0.000212,0.000213,1
3121,3121,,30,23,23,46,36,36,72,10,0.2944,0.320095,0.00005,0.010994,0.010904,0.590909
3269,3269,,30,20,20,40,33,33,66,10,0.286708,0.310635,0.000267,0.006823,0.006742,0.357895
3374,3374,,30,70,70,140,161,161,322,10,0.298789,0.331818,0.001,0.015918,0.015972,0.283023
3385,3385,,30,36,36,72,69,69,138,10,0.284728,0.31082,0.000478,0.011459,0.011573,0.61746
3387,3387,,30,26,25,51,52,51,103,10,0.28115,0.304087,0.000025,0.008934,0.007642,0.607692
3390,3390,,30,40,39,79,106,105,211,10,0.286708,0.312501,0.000097,0.014203,0.01289,0.536538
3368,3368,,30,43,43,86,81,81,162,10,0.286054,0.313252,0.000152,0.011201,0.011246,0.472868
3376,3376,,30,51,51,102,116,116,232,10,0.28631,0.314406,0.000822,0.012456,0.012488,0.423922
3389,3389,,30,31,32,63,51,51,102,10,0.287164,0.31283,0.000046,0.011265,0.01148,0.699597
3391,3391,,30,68,69,137,167,167,334,10,0.282249,0.314093,0.000909,0.010326,0.01051,0.216965
3393,3393,,30,56,56,112,137,137,274,10,0.29386,0.323947,0.000573,0.015628,0.015728,0.444156
2308,2308,,30,5,5,10,6,6,12,10,0.272521,0.2898,0.000004,0.002183,0.002122,0.5
2322,2322,,30,8,9,17,9,10,19,10,0.279732,0.299235,0.000011,0.004209,0.004149,0.611111
2326,2326,,30,9,9,18,12,11,23,10,0.279868,0.299524,0.00001,0.004417,0.004318,0.666667
2384,2384,,30,19,19,38,27,29,56,10,0.282084,0.303555,0.00158,0.006233,0.006168,0.327485
3034,3034,,30,12,12,24,22,20,42,10,0.29128,0.313742,0.000044,0.008163,0.008076,0.833333
3035,3035,,30,15,15,30,21,21,42,10,0.291869,0.315226,0.000146,0.007573,0.007494,0.628571
3239,3239,,30,27,26,53,45,44,89,10,0.287507,0.312403,0.01136,0.005927,0.005881,0.179487
3308,3308,,30,19,19,38,30,30,60,10,0.287507,0.310029,0.000222,0.006378,0.006375,0.380117
3369,3369,,30,37,36,73,75,74,149,10,0.283024,0.30851,0.00011,0.011244,0.009976,0.569069
3371,3371,,30,50,50,100,123,124,247,10,0.291604,0.319644,0.000405,0.013726,0.013749,0.457959
3372,3372,,30,35,34,69,63,61,124,10,0.289963,0.316226,0.000064,0.01375,0.012448,0.684874
3373,3373,,30,35,35,70,72,72,144,10,0.29178,0.318917,0.000172,0.01299,0.013012,0.630252
3375,3375,,30,39,38,77,82,81,163,10,0.285743,0.31175,0.000457,0.012627,0.01128,0.553981
3379,3379,,30,58,57,115,166,166,332,10,0.286452,0.315388,0.001995,0.013944,0.012629,0.363581
3384,3384,,30,30,29,59,62,61,123,10,0.281863,0.305704,0.00003,0.010362,0.009113,0.672414
3392,3392,,30,17,17,34,28,28,56,10,0.280767,0.302337,0.000006,0.007253,0.007219,0.727941
3394,3394,,30,31,31,62,66,66,132,10,0.285771,0.310179,0.000856,0.009699,0.009736,0.678495
3400,3400,,30,34,34,68,61,61,122,10,0.284559,0.309555,0.001763,0.009944,0.009981,0.450089
3404,3404,,30,46,46,92,98,98,196,10,0.287078,0.31406,0.00025,0.012956,0.01299,0.402415
3774,3774,,40,33,31,64,43,41,84,10,0.29252,0.316612,0.054546,0.006837,0.005016,0.069129
3928,3928,,30,19,19,38,37,37,74,10,0.286423,0.308141,0.000802,0.005741,0.00569,0.356725
3940,3940,,30,30,30,60,62,61,123,10,0.304977,0.333735,0.005281,0.011667,0.011603,0.3
4108,4108,,30,39,38,77,85,84,169,10,0.285827,0.311894,0.00008,0.013234,0.011967,0.625506
4120,4120,,30,30,30,60,73,73,146,10,0.28705,0.312524,0.000041,0.010783,0.01085,0.694253
4140,4140,,30,9,9,18,12,12,24,10,0.289005,0.309584,0.000003,0.006214,0.00613,0.777778
4144,4144,,30,38,37,75,74,73,147,10,0.286594,0.312039,0.000111,0.012304,0.012154,0.480085
4149,4149,,30,16,16,32,16,16,32,10,0.281095,0.302816,0.000026,0.005934,0.005896,0.725
4380,4380,,30,22,22,44,38,38,76,10,0.284615,0.307546,0.000029,0.008681,0.008663,0.662338
6347,6347,,30,28,28,56,48,48,96,10,0.277313,0.301067,0.000048,0.007668,0.007684,0.652116
2334,2334,,30,15,15,30,22,22,44,10,0.270808,0.289365,0.000156,0.001884,0.001855,0.219048
2347,2347,,30,7,7,14,10,10,20,10,0.269921,0.286535,0,0.00164,0.00161,0.714286
2370,2370,,30,21,21,42,37,37,74,10,0.280357,0.303265,0.004278,0.006151,0.006096,0.235714
2927,2927,,7,19,19,38,27,27,54,10,0.291427,0.318132,0.000853,0.009066,0.008999,0.406433
2933,2933,,7,13,13,26,18,18,36,10,0.290254,0.31582,0.001733,0.006867,0.006795,0.358974
2934,2934,,7,20,20,40,29,28,57,10,0.291486,0.318363,0.00062,0.008846,0.008775,0.342105
3380,3380,,30,5,5,10,8,8,16,10,0.285037,0.30699,0.000006,0.005167,0.005093,0.7
2280,2280,,30,2,2,4,2,2,4,11,0.228504,0.240508,0,0.000295,0.000299,1
2286,2286,,30,1,1,2,2,2,4,11,0.242562,0.254475,0,0.0002,0.0002,0
2299,2299,,30,2,2,4,4,3,7,11,0.243195,0.255844,0,0.000331,0.000332,1
2324,2324,,30,5,5,10,5,5,10,10,0.271854,0.290953,0.000002,0.002619,0.002581,0.7
3943,3943,,30,6,6,12,9,9,18,11,0.24338,0.256826,0.000002,0.000513,0.000517,0.4
5994,5994,,30,2,2,4,3,3,6,11,0.243195,0.255844,0,0.000331,0.000332,1
5999,5999,,30,3,3,6,3,3,6,10,0.262889,0.280165,0.000001,0.001154,0.001154,0.666667
6476,6476,,30,6,6,12,6,6,12,10,0.271164,0.289538,0.000001,0.002479,0.0024,0.571429
2288,2288,,30,1,1,2,3,3,6,11,0.242562,0.254475,0,0.0002,0.0002,0
2290,2290,,30,1,1,2,2,2,4,11,0.242562,0.254475,0,0.0002,0.0002,0
2291,2291,,30,1,1,2,1,1,2,11,0.242562,0.254475,0,0.0002,0.0002,0
2295,2295,,30,1,1,2,1,1,2,11,0.208707,0.217609,0,0.000025,0.000025,0
2313,2313,,30,9,9,18,10,10,20,10,0.26373,0.282752,0.001412,0.001545,0.001547,0.222222
2296,2296,,30,1,1,2,2,2,4,11,0.242562,0.254475,0,0.0002,0.0002,0
2297,2297,,30,1,1,2,1,1,2,11,0.208707,0.217609,0,0.000025,0.000025,0
2304,2304,,30,2,2,4,2,2,4,11,0.227513,0.239142,0,0.000189,0.000191,0
5997,5997,,30,2,2,4,2,2,4,11,0.227405,0.238853,0,0.000185,0.000188,0
2307,2307,,30,8,8,16,10,10,20,10,0.271803,0.291184,0.000083,0.002385,0.002348,0.392857
2316,2316,,30,3,3,6,3,3,6,11,0.242909,0.255393,0,0.000267,0.000268,1
2310,2310,,30,2,2,4,3,3,6,11,0.242705,0.254897,0,0.00023,0.00023,1
2311,2311,,30,2,2,4,4,4,8,10,0.269468,0.286304,0,0.001287,0.001249,0
2312,2312,,30,6,5,11,9,9,18,10,0.269619,0.286997,0.000089,0.001366,0.001291,0.2
2327,2327,,30,5,5,10,6,6,12,10,0.271854,0.290953,0.000002,0.002587,0.002549,0.6
2328,2328,,30,1,1,2,1,1,2,11,0.242562,0.254475,0,0.0002,0.0002,0
2330,2330,,30,2,2,4,2,2,4,10,0.269468,0.286304,0,0.001287,0.001249,0
2332,2332,,30,2,2,4,3,4,7,11,0.242705,0.254897,0,0.00023,0.00023,1
2333,2333,,30,4,4,8,5,5,10,10,0.271624,0.290318,0.000003,0.002309,0.002271,0.333333
2335,2335,,30,1,1,2,1,1,2,11,0.242562,0.254475,0,0.0002,0.0002,0
2336,2336,,30,1,1,2,1,1,2,11,0.242562,0.254475,0,0.0002,0.0002,0
2337,2337,,30,3,3,6,4,4,8,10,0.269543,0.286593,0,0.001386,0.001349,0.666667
2340,2340,,30,1,1,2,1,2,3,11,0.242562,0.254475,0,0.0002,0.0002,0
2345,2345,,30,1,1,2,3,2,5,11,0.242562,0.254475,0,0.0002,0.0002,0
2346,2346,,30,1,1,2,1,1,2,11,0.242562,0.254475,0,0.0002,0.0002,0
2352,2352,,30,1,1,2,1,1,2,11,0.242562,0.254475,0,0.0002,0.0002,0
2378,2378,,30,11,11,22,32,31,63,10,0.258927,0.277809,0.000439,0.001453,0.001469,0.236364
2387,2387,,30,6,3,9,6,3,9,11,0.220087,0.229935,0.000673,0.00109,0.000105,0.466667
2390,2390,,30,3,3,6,3,3,6,11,0.242929,0.255451,0.000016,0.000301,0.000317,0.833333
3409,3409,,30,1,1,2,1,1,2,11,0.242562,0.254475,0,0.0002,0.0002,0
5996,5996,,30,1,1,2,1,1,2,11,0.242562,0.254475,0,0.0002,0.0002,0
5998,5998,,30,1,1,2,1,1,2,11,0.242562,0.254475,0,0.0002,0.0002,0
6001,6001,,30,1,1,2,1,1,2,11,0.242562,0.254475,0,0.0002,0.0002,0
2361,2361,,30,2,2,4,4,4,8,11,0.219501,0.2302,0,0.000121,0.000122,1
2365,2365,,30,2,2,4,3,3,6,11,0.219501,0.2302,0,0.000121,0.000122,1
2374,2374,,30,2,2,4,3,3,6,11,0.219501,0.2302,0,0.000121,0.000122,1
2380,2380,,30,2,2,4,3,3,6,11,0.219501,0.2302,0,0.000121,0.000122,1
2381,2381,,30,5,5,10,6,6,12,10,0.284223,0.305142,0.000011,0.004818,0.004757,0.9
4189,4189,,30,2,2,4,2,2,4,10,0.269493,0.287509,0,0.001417,0.001419,1
6003,6003,,30,1,1,2,2,2,4,11,0.218985,0.229102,0,0.000098,0.000099,0
6005,6005,,30,1,1,2,1,1,2,11,0.218985,0.229102,0,0.000098,0.000099,0
6007,6007,,30,2,2,4,3,3,6,11,0.219501,0.2302,0,0.000121,0.000122,1
6008,6008,,30,4,4,8,7,7,14,10,0.279977,0.299846,0.000011,0.002959,0.002936,0.666667
2430,2430,,30,4,4,8,7,7,14,10,0.273425,0.292524,0,0.002702,0.002634,1
6389,6389,,30,14,14,28,17,17,34,10,0.278061,0.299713,0.000001,0.005935,0.005915,0.758242
2388,2388,,30,1,1,2,1,1,2,11,0.220037,0.229531,0,0.000099,0.0001,0
2396,2396,,30,1,1,2,1,1,2,12,0.180398,0.185711,0,0.000002,0.000017,0
2399,2399,,30,1,1,2,2,2,4,10,0.250477,0.264496,0,0.000431,0.0004,0
2400,2400,,30,3,3,6,7,7,14,10,0.250543,0.264901,0,0.000556,0.000527,1
2401,2401,,30,2,2,4,2,2,4,10,0.250521,0.264727,0,0.000532,0.000503,1
2404,2404,,30,4,4,8,8,8,16,10,0.250586,0.265132,0.000669,0.000556,0.000527,0.5
2422,2422,,30,2,2,4,5,5,10,10,0.250521,0.264727,0,0.000532,0.000503,1
2423,2423,,30,2,2,4,6,6,12,10,0.250521,0.264727,0,0.000532,0.000503,1
2425,2425,,30,2,2,4,3,3,6,10,0.250521,0.264727,0,0.000532,0.000503,1
2429,2429,,30,3,3,6,7,7,14,10,0.250543,0.264901,0,0.000556,0.000527,1
2433,2433,,30,3,3,6,6,6,12,10,0.250543,0.264901,0,0.000539,0.00051,0.666667
2435,2435,,30,1,1,2,2,2,4,10,0.250477,0.264496,0,0.000431,0.0004,0
3994,3994,,30,1,1,2,4,4,8,10,0.250477,0.264496,0,0.000431,0.0004,0
3999,3999,,30,20,20,40,30,30,60,10,0.274596,0.298598,0.00496,0.003064,0.003045,0.260526
4002,4002,,30,2,2,4,4,4,8,10,0.250521,0.264727,0,0.000532,0.000503,1
4090,4090,,30,6,6,12,13,13,26,10,0.268166,0.286695,0.000042,0.001526,0.001491,0.6
4199,4199,,30,2,2,4,4,4,8,10,0.250499,0.26467,0,0.00044,0.000409,1
4200,4200,,30,2,2,4,3,3,6,10,0.250521,0.264727,0,0.000532,0.000503,1
4201,4201,,30,2,2,4,3,3,6,10,0.250521,0.264727,0,0.000532,0.000503,1
4202,4202,,30,1,1,2,2,2,4,10,0.250477,0.264496,0,0.000431,0.0004,0
4203,4203,,30,2,2,4,5,5,10,10,0.250521,0.264727,0,0.000532,0.000503,1
4204,4204,,30,2,2,4,3,3,6,10,0.250521,0.264727,0,0.000532,0.000503,1
5988,5988,,30,1,1,2,1,1,2,10,0.250477,0.264496,0,0.000431,0.0004,0
6011,6011,,30,2,2,4,3,3,6,10,0.250521,0.264727,0,0.000532,0.000503,1
6016,6016,,30,2,2,4,2,2,4,10,0.250521,0.264727,0,0.000532,0.000503,1
6018,6018,,30,1,1,2,1,1,2,10,0.250477,0.264496,0,0.000431,0.0004,0
6019,6019,,30,1,1,2,1,1,2,10,0.250477,0.264496,0,0.000431,0.0004,0
6020,6020,,30,1,1,2,1,1,2,10,0.250477,0.264496,0,0.000431,0.0004,0
6021,6021,,30,1,1,2,1,1,2,10,0.250477,0.264496,0,0.000431,0.0004,0
6022,6022,,30,1,1,2,2,2,4,10,0.250477,0.264496,0,0.000431,0.0004,0
6023,6023,,30,1,1,2,1,1,2,10,0.250477,0.264496,0,0.000431,0.0004,0
6024,6024,,30,2,2,4,3,3,6,10,0.250521,0.264727,0,0.000532,0.000503,1
6025,6025,,30,1,1,2,1,1,2,10,0.250477,0.264496,0,0.000431,0.0004,0
6026,6026,,30,1,1,2,2,2,4,10,0.250477,0.264496,0,0.000431,0.0004,0
6386,6386,,30,18,18,36,27,27,54,10,0.279841,0.303109,0.000023,0.00681,0.006789,0.627451
6733,6733,,30,1,1,2,1,1,2,10,0.250477,0.264496,0,0.000431,0.0004,0
6745,6745,,30,1,1,2,2,2,4,10,0.250477,0.264496,0,0.000431,0.0004,0
6791,6791,,30,1,1,2,1,1,2,10,0.250477,0.264496,0,0.000431,0.0004,0
6013,6013,,30,1,1,2,1,1,2,11,0.200389,0.207572,0,0.000008,0.000009,0
2440,2440,,34,2,2,4,2,2,4,11,0.208813,0.219804,0,0.000065,0.000066,1
2442,2442,,34,39,39,78,52,52,104,10,0.26054,0.282863,0.017324,0.001774,0.001759,0.041667
2599,2599,,34,24,24,48,50,48,98,10,0.262411,0.282985,0.004804,0.002326,0.002319,0.256923
2441,2441,,34,1,1,2,1,1,2,11,0.206704,0.2164,0,0.000028,0.000028,0
2452,2452,,34,6,6,12,6,6,12,10,0.245763,0.259235,0.000113,0.000374,0.000368,0.466667
2454,2454,,34,1,1,2,1,1,2,11,0.206704,0.2164,0,0.000028,0.000028,0
2455,2455,,34,1,1,2,1,1,2,11,0.206704,0.2164,0,0.000028,0.000028,0
2456,2456,,34,1,1,2,1,1,2,11,0.206704,0.2164,0,0.000028,0.000028,0
2458,2458,,34,1,1,2,1,1,2,11,0.206704,0.2164,0,0.000028,0.000028,0
2460,2460,,34,1,1,2,1,1,2,11,0.206704,0.2164,0,0.000028,0.000028,0
2461,2461,,34,2,2,4,2,2,4,11,0.206719,0.216573,0,0.000034,0.000034,1
2467,2467,,34,1,1,2,1,1,2,11,0.206704,0.2164,0,0.000028,0.000028,0
2468,2468,,34,1,1,2,1,1,2,11,0.206704,0.2164,0,0.000028,0.000028,0
2469,2469,,34,2,2,4,3,3,6,11,0.22044,0.232176,0,0.000091,0.000083,1
2470,2470,,34,1,1,2,1,1,2,11,0.206704,0.2164,0,0.000028,0.000028,0
2471,2471,,34,3,3,6,3,3,6,10,0.251942,0.265314,0.000045,0.000484,0.000484,0.333333
2474,2474,,34,1,2,3,1,2,3,10,0.25192,0.265141,0.000009,0.000028,0.000481,0
2476,2476,,34,5,5,10,6,6,12,11,0.225117,0.23761,0.000025,0.000186,0.000178,0.4
2477,2477,,34,1,1,2,2,2,4,11,0.206704,0.2164,0,0.000028,0.000028,0
2487,2487,,34,2,2,4,2,2,4,11,0.206719,0.216573,0,0.000029,0.000029,1
2488,2488,,34,1,1,2,1,1,2,11,0.206704,0.2164,0,0.000028,0.000028,0
2490,2490,,34,2,2,4,2,2,4,11,0.206719,0.216573,0,0.000029,0.000029,1
2491,2491,,34,1,1,2,1,1,2,12,0.171327,0.176726,0.000334,0.000028,0,0.5
2492,2492,,34,1,1,2,1,1,2,11,0.206704,0.2164,0,0.000028,0.000028,0
2496,2496,,34,2,2,4,2,2,4,11,0.206719,0.216573,0,0.000029,0.000029,1
2497,2497,,34,3,3,6,3,3,6,11,0.206734,0.216746,0,0.000029,0.00003,0.666667
2501,2501,,34,1,1,2,1,1,2,11,0.206704,0.2164,0,0.000028,0.000028,0
2508,2508,,34,1,1,2,1,1,2,11,0.206704,0.2164,0,0.000028,0.000028,0
2509,2509,,34,2,2,4,2,2,4,11,0.206719,0.216573,0,0.000029,0.000029,1
2513,2513,,34,4,4,8,5,5,10,10,0.251964,0.265487,0.000187,0.000487,0.000488,0.333333
2517,2517,,34,1,1,2,1,1,2,11,0.206704,0.2164,0,0.000028,0.000028,0
2555,2555,,34,11,11,22,21,21,42,10,0.261864,0.280155,0.001136,0.001934,0.001935,0.472727
2699,2699,,34,8,9,17,11,11,22,10,0.262125,0.280155,0.000156,0.001815,0.001816,0.416667
4061,4061,,34,4,4,8,4,4,8,11,0.20815,0.218384,0.000002,0.000037,0.000037,0.5
6777,6777,,34,1,1,2,3,3,6,11,0.206704,0.2164,0,0.000028,0.000028,0
2512,2512,,34,1,1,2,1,1,2,11,0.206719,0.216457,0.000334,0,0.000028,0.5
2495,2495,,2,1,1,2,1,1,2,10,0.250673,0.262496,0,0.000453,0.000453,0
2518,2518,,32,0,1,1,0,1,1,1,1,1,0,0,0,0
7369,7369,,32,1,0,1,1,0,1,0,0,0,0,0,0,0
2522,2522,,34,8,8,16,15,14,29,10,0.257449,0.274037,0,0.001661,0.001626,0.928571
2590,2590,,34,8,8,16,12,13,25,10,0.257403,0.273921,0,0.001716,0.001681,0.964286
2612,2612,,34,25,24,49,59,58,117,10,0.258255,0.277819,0.001919,0.001646,0.001621,0.33
2524,2524,,34,2,2,4,4,4,8,11,0.205103,0.213803,0,0.00002,0.00002,1
2548,2548,,34,18,18,36,44,44,88,10,0.257978,0.276491,0.003233,0.001205,0.001204,0.27451
7367,7367,,34,2,2,4,5,5,10,11,0.205103,0.213803,0,0.00002,0.00002,1
2525,2525,,34,3,2,5,3,2,5,11,0.205219,0.213907,0,0.00088,0.000038,1
2538,2538,,34,16,16,32,27,27,54,10,0.25814,0.276428,0.001323,0.001264,0.001277,0.4125
2619,2619,,34,9,9,18,14,14,28,10,0.257564,0.27447,0.000167,0.001116,0.00113,0.680556
2526,2526,,34,16,16,32,30,31,61,10,0.258718,0.277173,0.002961,0.00173,0.001841,0.224265
2566,2566,,34,2,2,4,5,5,10,11,0.205599,0.214409,0,0.000031,0.000029,1
2584,2584,,34,3,3,6,6,5,11,11,0.222017,0.234848,0.000001,0.000133,0.000134,0.5
2591,2591,,34,1,1,2,2,2,4,11,0.205556,0.21412,0,0.00003,0.000028,0
2616,2616,,34,8,8,16,17,17,34,10,0.257518,0.274123,0.000093,0.001495,0.001643,0.714286
2629,2629,,34,2,2,4,4,4,8,11,0.205585,0.214351,0,0.000031,0.00003,1
4092,4092,,34,4,5,9,9,9,18,11,0.212879,0.223773,0.000406,0.000081,0.000078,0.4
7370,7370,,34,1,0,1,1,0,1,0,0,0,0,0.00003,0,0
7532,7532,,34,4,5,9,6,7,13,11,0.217581,0.229601,0.000011,0.000114,0.000115,0.3
2528,2528,,34,14,14,28,27,27,54,10,0.257196,0.274181,0.001271,0.001008,0.001006,0.153846
2570,2570,,34,4,4,8,6,6,12,10,0.256944,0.272391,0.000186,0.000886,0.000883,0.666667
2574,2574,,34,4,4,8,6,6,12,11,0.205424,0.215108,0.000001,0.000056,0.000057,0.333333
2587,2587,,34,2,2,4,3,3,6,11,0.217499,0.229023,0,0.000098,0.000099,0
2613,2613,,34,15,15,30,29,29,58,10,0.258001,0.276145,0.000009,0.001807,0.001827,0.680952
2615,2615,,34,4,4,8,7,7,14,11,0.217828,0.230294,0.000001,0.000156,0.000157,0.5
2633,2633,,34,12,12,24,21,21,42,10,0.257564,0.274816,0.000458,0.001522,0.001525,0.5
2635,2635,,34,4,4,8,7,7,14,11,0.212112,0.223578,0,0.000114,0.000114,0.666667
6039,6039,,34,3,3,6,7,7,14,10,0.257013,0.27242,0,0.000995,0.00101,0.666667
6735,6735,,34,3,3,6,5,5,10,11,0.205088,0.214103,0,0.000058,0.000057,0.666667
6913,6913,,34,3,3,6,5,5,10,11,0.205409,0.214935,0,0.000043,0.000043,0.666667
7364,7364,,34,2,2,4,6,6,12,11,0.20538,0.214704,0,0.000042,0.000043,0
7395,7395,,34,4,4,8,6,6,12,10,0.256944,0.272391,0.000099,0.000884,0.000882,0.833333
2545,2545,,34,25,25,50,59,59,118,10,0.258394,0.278131,0.002221,0.001976,0.001992,0.33
2554,2554,,34,9,9,18,16,16,32,10,0.257771,0.274903,0.000004,0.001551,0.001553,0.777778
2562,2562,,34,18,18,36,33,32,65,10,0.258209,0.277011,0.000565,0.001902,0.001865,0.51634
2572,2572,,34,3,2,5,5,4,9,11,0.221846,0.234213,0,0.00013,0.000128,0.666667
2575,2575,,34,6,6,12,8,8,16,10,0.257288,0.273401,0,0.001608,0.001572,1
2577,2577,,34,2,1,3,2,1,3,11,0.222154,0.232853,0,0.000208,0.000052,1
2604,2604,,34,3,3,6,7,7,14,11,0.234634,0.24823,0,0.000345,0.000311,1
2607,2607,,34,7,7,14,16,16,32,11,0.222616,0.236933,0.000721,0.000256,0.000257,0.333333
2609,2609,,34,4,4,8,7,7,14,11,0.222548,0.235847,0.000698,0.000111,0.000113,0.166667
2618,2618,,34,23,23,46,48,48,96,10,0.245033,0.263551,0.00024,0.001082,0.001116,0.335968
2623,2623,,34,6,6,12,9,9,18,10,0.257265,0.273315,0,0.001443,0.001591,0.933333
2638,2638,,34,13,13,26,26,26,52,10,0.257656,0.275134,0.000813,0.001675,0.001707,0.519231
4209,4209,,34,9,8,17,16,16,32,10,0.257518,0.27421,0.000005,0.001304,0.001311,0.875
4214,4214,,34,2,2,4,4,4,8,11,0.221863,0.23427,0,0.000131,0.000135,1
6034,6034,,34,3,3,6,4,4,8,11,0.226637,0.239853,0,0.00026,0.000358,1
7125,7125,,34,5,6,11,5,6,11,10,0.244121,0.259213,0,0.000614,0.000772,0.933333
7373,7373,,34,2,2,4,3,3,6,11,0.234596,0.247999,0,0.000239,0.000259,1
7376,7376,,34,3,3,6,5,5,10,11,0.221915,0.234559,0.000002,0.000133,0.000137,0.333333
2533,2533,,34,1,1,2,2,2,4,11,0.212597,0.222398,0,0.000051,0.000049,0
2535,2535,,34,5,5,10,7,7,14,11,0.205702,0.215651,0,0.000086,0.000086,0.8
2581,2581,,34,10,10,20,19,19,38,10,0.25738,0.274152,0.000145,0.001059,0.001057,0.666667
2586,2586,,34,9,9,18,17,17,34,10,0.257265,0.273748,0.000463,0.001009,0.001007,0.611111
7380,7380,,34,3,3,6,4,4,8,11,0.205658,0.215247,0,0.000054,0.000053,1
2569,2569,,34,7,7,14,14,13,27,10,0.243709,0.258486,0.000002,0.001494,0.000691,0.892857
2595,2595,,34,7,6,13,10,9,19,10,0.257128,0.272997,0.000003,0.001429,0.001345,0.904762
2544,2544,,34,1,1,2,2,2,4,11,0.20519,0.213676,0,0.000021,0.00002,0
2539,2539,,34,3,3,6,5,5,10,11,0.208045,0.217875,0.000005,0.000063,0.000064,0.333333
6477,6477,,34,4,3,7,6,5,11,11,0.204637,0.212717,0.000002,0.000053,0.000016,0.166667
2543,2543,,34,2,3,5,2,3,5,11,0.205365,0.214733,0,0.000028,0.000054,0.666667
6037,6037,,34,2,2,4,2,2,4,11,0.205292,0.214357,0.000001,0.000027,0.000027,0.5
2547,2547,,34,2,2,4,2,2,4,11,0.205585,0.215131,0,0.00005,0.000049,1
7383,7383,,34,1,1,2,1,1,2,11,0.205351,0.214265,0,0.000032,0.000032,0
2550,2550,,34,3,3,6,3,3,6,11,0.212081,0.223318,0,0.000097,0.000096,0.666667
2637,2637,,34,2,2,4,4,4,8,11,0.205103,0.213803,0,0.00002,0.00002,1
6073,6073,,34,3,3,6,8,8,16,11,0.205263,0.214328,0.000001,0.000024,0.000024,0.666667
7382,7382,,34,2,2,4,4,4,8,11,0.205176,0.214005,0,0.000035,0.000036,1
2549,2549,,34,1,1,2,2,2,4,12,0.182048,0.188985,0,0.000002,0.000002,0
2594,2594,,34,1,1,2,1,1,2,12,0.175355,0.180845,0.000334,0.000051,0,0.5
2624,2624,,34,3,2,5,6,4,10,11,0.212612,0.222571,0,0.000053,0.00005,0.666667
2628,2628,,34,1,2,3,2,4,6,11,0.212612,0.222571,0,0.000051,0.00005,1
7372,7372,,34,3,2,5,4,3,7,11,0.212628,0.222629,0.000269,0.000052,0.000049,0.666667
7396,7396,,34,1,0,1,1,0,1,0,0,0,0,0.000051,0,0
7398,7398,,34,2,2,4,5,4,9,11,0.212612,0.222571,0,0.000052,0.00005,1
7399,7399,,34,2,2,4,3,3,6,11,0.212612,0.222571,0,0.000052,0.00005,1
7530,7530,,34,2,2,4,2,3,5,11,0.212612,0.222571,0,0.000052,0.00005,1
7384,7384,,34,2,2,4,3,3,6,11,0.207581,0.216357,0.000003,0.000031,0.000032,0
2556,2556,,34,2,2,4,5,5,10,11,0.227854,0.238936,0,0.000226,0.000102,1
7394,7394,,34,2,2,4,4,4,8,11,0.205307,0.214271,0,0.000054,0.000055,1
2576,2576,,34,3,3,6,4,4,8,10,0.256807,0.271929,0.000003,0.000919,0.000916,0.333333
2602,2602,,34,3,3,6,5,5,10,10,0.257013,0.272362,0.00043,0.000879,0.000878,0.5
2636,2636,,34,2,2,4,2,2,4,10,0.256739,0.27164,0.000201,0.000842,0.00084,0
4305,4305,,34,2,2,4,2,2,4,10,0.256807,0.271663,0,0.00087,0.000869,1
2582,2582,,34,1,1,2,1,1,2,12,0.186784,0.192827,0.000334,0.000138,0,0.5
7407,7407,,34,1,1,2,1,1,2,11,0.229649,0.240889,0.000334,0,0.000154,0.5
7397,7397,,34,1,1,2,1,1,2,11,0.212612,0.222456,0.000334,0,0.000049,0.5
2596,2596,,34,2,2,4,4,4,8,11,0.207925,0.217396,0.000334,0.000001,0.000038,0.5
6040,6040,,34,3,3,6,6,6,12,11,0.20794,0.217569,0.000836,0.000038,0.000037,0.166667
2611,2611,,34,2,2,4,3,4,7,11,0.20791,0.217338,0.000334,0.000038,0.000037,0.5
6069,6069,,34,1,1,2,2,2,4,12,0.172155,0.177418,0.000167,0.000037,0,0.5
2603,2603,,34,1,2,3,2,4,6,11,0.20791,0.217338,0,0.000001,0.000038,1
7381,7381,,34,1,1,2,2,2,4,12,0.182094,0.189389,0,0.000004,0.000004,0
2812,2812,,34,4,5,9,7,5,12,11,0.24375,0.256669,0.00095,0.000311,0.000336,0
6036,6036,,34,1,1,2,2,2,4,11,0.229631,0.240831,0,0.000138,0.000154,0
2632,2632,,34,1,1,2,2,2,4,12,0.172155,0.177418,0,0.000001,0.000001,0
2641,2641,,34,4,6,10,5,7,12,10,0.245429,0.258155,0.000047,0.000023,0.000323,0.466667
2645,2645,,34,5,5,10,9,10,19,10,0.245033,0.257214,0,0.000297,0.000297,0.766667
2649,2649,,34,6,7,13,12,11,23,10,0.245554,0.258531,0.000072,0.000297,0.0004,0.47619
2651,2651,,34,8,8,16,12,12,24,10,0.249029,0.262879,0.000072,0.000609,0.000605,0.446429
2762,2762,,34,12,10,22,20,18,38,11,0.224661,0.237102,0.003159,0.001629,0.000096,0.19697
2802,2802,,34,3,3,6,5,4,9,11,0.243032,0.255063,0.000521,0.000313,0.000309,0
2642,2642,,2,2,1,3,3,2,5,11,0.196661,0.202749,0,0.000009,0.000004,1
2665,2665,,2,4,5,9,6,7,13,10,0.244784,0.256896,0.000502,0.00028,0.000286,0.45
2662,2662,,34,4,3,7,4,3,7,10,0.244721,0.256492,0,0.000291,0.000287,1
4312,4312,,34,5,5,10,7,8,15,10,0.245033,0.257214,0,0.000297,0.000297,0.85
2656,2656,,2,3,2,5,3,2,5,10,0.24468,0.256261,0,0.00028,0.000277,1
2657,2657,,28,2,2,4,2,2,4,10,0.249503,0.262143,0.000122,0.000317,0.000319,0
2664,2664,,2,3,3,6,3,3,6,10,0.244721,0.256492,0,0.00028,0.000282,0.833333
6042,6042,,34,2,2,4,2,2,4,10,0.244701,0.256319,0,0.000281,0.000283,1
2670,2670,,2,1,1,2,2,2,4,11,0.216797,0.226853,0,0.000077,0.000116,0
2671,2671,,2,2,2,4,5,4,9,11,0.229193,0.24018,0,0.000218,0.000218,1
2672,2672,,2,2,2,4,4,4,8,11,0.229193,0.24018,0,0.000218,0.000218,1
6045,6045,,2,1,1,2,1,1,2,11,0.228323,0.238874,0,0.000141,0.000102,0
6046,6046,,2,2,2,4,2,2,4,11,0.229193,0.24018,0,0.000218,0.000218,1
2680,2680,,2,1,1,2,1,1,2,11,0.216797,0.226853,0,0.000077,0.000116,0
2683,2683,,2,1,1,2,1,1,2,11,0.216797,0.226853,0,0.000077,0.000116,0
2686,2686,,2,1,1,2,1,1,2,11,0.216797,0.226853,0,0.000077,0.000116,0
6047,6047,,2,1,1,2,1,1,2,11,0.216797,0.226853,0,0.000077,0.000116,0
6750,6750,,2,1,1,2,2,2,4,11,0.216797,0.226853,0,0.000077,0.000116,0
2759,2759,,34,6,5,11,9,10,19,11,0.223964,0.235012,0.000041,0.000118,0.00011,0.566667
2705,2705,,2,2,2,4,3,3,6,10,0.253893,0.270666,0,0.001048,0.001049,1
2706,2706,,2,3,3,6,4,4,8,10,0.245179,0.259322,0.000347,0.000493,0.000494,0.333333
6051,6051,,2,2,2,4,2,2,4,11,0.196943,0.204235,0,0.000015,0.000015,0
2708,2708,,2,6,6,12,9,9,18,10,0.2452,0.259726,0.000002,0.000468,0.00047,0.4
2713,2713,,2,3,3,6,5,5,10,10,0.245096,0.259091,0,0.000445,0.000447,1
2729,2729,,2,11,11,22,15,15,30,10,0.245387,0.260823,0.001343,0.00057,0.000571,0.154545
2751,2751,,2,2,2,4,2,2,4,10,0.245075,0.258917,0,0.000438,0.00044,1
2752,2752,,2,3,3,6,3,3,6,10,0.245096,0.259091,0,0.000445,0.000447,1
7355,7355,,2,2,2,4,2,2,4,10,0.245075,0.258917,0,0.000438,0.00044,1
2712,2712,,2,1,1,2,1,1,2,10,0.245054,0.258744,0,0.000431,0.000432,0
2717,2717,,2,2,2,4,2,2,4,10,0.245116,0.259033,0,0.00044,0.000441,1
2718,2718,,2,1,1,2,1,1,2,10,0.245054,0.258744,0,0.000431,0.000432,0
2719,2719,,2,1,1,2,2,2,4,10,0.245054,0.258744,0,0.000431,0.000432,0
2724,2724,,2,2,2,4,3,3,6,10,0.245116,0.259033,0,0.00044,0.000441,1
2728,2728,,33,4,3,7,4,3,7,10,0.245137,0.259206,0.001671,0.000431,0.000432,0
2731,2731,,2,2,2,4,3,3,6,10,0.245116,0.259033,0,0.00044,0.000441,1
2732,2732,,2,2,2,4,2,2,4,10,0.245096,0.258975,0,0.000438,0.000439,1
2733,2733,,2,1,1,2,2,2,4,10,0.245054,0.258744,0,0.000431,0.000432,0
2734,2734,,2,2,2,4,4,4,8,10,0.245096,0.258975,0.000321,0.000431,0.000432,0
2738,2738,,2,2,2,4,2,2,4,10,0.245096,0.258975,0,0.000438,0.000439,1
2739,2739,,2,3,3,6,6,6,12,10,0.245137,0.259206,0,0.000485,0.000486,0.666667
2741,2741,,2,1,1,2,2,2,4,10,0.245054,0.258744,0,0.000431,0.000432,0
2742,2742,,2,2,2,4,2,3,5,10,0.245137,0.259091,0,0.000493,0.000494,1
2746,2746,,2,2,2,4,2,2,4,10,0.24747,0.26192,0,0.000739,0.000751,1
2747,2747,,2,1,1,2,1,1,2,10,0.245054,0.258744,0,0.000431,0.000432,0
2748,2748,,2,2,2,4,3,3,6,10,0.245075,0.258917,0,0.000546,0.000547,1
2750,2750,,2,2,1,3,2,1,3,10,0.245054,0.258744,0.000334,0.000431,0.000432,0
2753,2753,,2,4,3,7,6,5,11,10,0.245158,0.259264,0.000669,0.000502,0.000441,0.5
2755,2755,,2,1,1,2,2,2,4,10,0.245054,0.258744,0,0.000431,0.000432,0
2756,2756,,2,4,5,9,5,6,11,10,0.245158,0.259495,0.000669,0.000445,0.000453,0.3
6054,6054,,2,2,1,3,2,1,3,10,0.245054,0.258744,0,0.000438,0.000432,1
6055,6055,,2,1,1,2,2,2,4,10,0.245054,0.258744,0,0.000431,0.000432,0
7359,7359,,2,1,1,2,1,1,2,10,0.245054,0.258744,0,0.000431,0.000432,0
2711,2711,,2,1,1,2,1,1,2,11,0.19705,0.204524,0,0.000009,0.000009,0
2716,2716,,2,1,1,2,2,2,4,11,0.219702,0.229596,0,0.000062,0.000062,0
2722,2722,,2,1,1,2,1,1,2,11,0.219702,0.229596,0,0.000062,0.000062,0
2725,2725,,2,1,1,2,1,1,2,11,0.219702,0.229596,0,0.000062,0.000062,0
5477,5477,,33,1,1,2,1,1,2,11,0.196889,0.203947,0,0.000007,0.000007,0
6052,6052,,33,1,1,2,1,1,2,11,0.196889,0.203947,0,0.000007,0.000007,0
5476,5476,,2,1,1,2,2,2,4,11,0.19705,0.204524,0,0.000009,0.000009,0
2743,2743,,2,1,1,2,1,1,2,11,0.200403,0.207577,0,0.000014,0.000014,0
6053,6053,,2,1,1,2,1,1,2,11,0.196903,0.203975,0,0.000007,0.000008,0
7358,7358,,2,1,1,2,1,1,2,11,0.196903,0.204033,0,0.000007,0.000007,0
2767,2767,,34,4,4,8,5,5,10,11,0.223929,0.234781,0.000015,0.000087,0.000109,0.916667
2768,2768,,34,5,5,10,9,8,17,11,0.223912,0.234838,0.001113,0.000085,0.000109,0.3
2769,2769,,34,8,9,17,12,15,27,11,0.224016,0.235647,0.002057,0.000006,0.000111,0.236111
2761,2761,,34,3,3,6,6,5,11,12,0.183529,0.19038,0.000163,0.000003,0.000026,0.666667
6058,6058,,34,2,3,5,3,4,7,12,0.183052,0.189375,0,0.000002,0,0.666667
7317,7317,,34,2,2,4,4,4,8,12,0.183483,0.190034,0.000163,0.000002,0.000026,0
2765,2765,,34,1,1,2,1,1,2,11,0.223513,0.233377,0,0.000082,0.000081,0
2772,2772,,34,1,1,2,2,2,4,12,0.182959,0.18874,0,0.000002,0.000001,0
4247,4247,,34,2,2,4,4,4,8,12,0.183075,0.189346,0,0.000004,0.000001,0
6056,6056,,34,2,1,3,2,1,3,12,0.183029,0.189029,0,0.000002,0,1
6060,6060,,34,2,2,4,4,4,8,12,0.183052,0.18926,0,0.000002,0,0
2781,2781,,2,3,3,6,3,3,6,11,0.242705,0.254515,0,0.000318,0.000318,1
2801,2801,,2,3,3,6,4,3,7,11,0.242705,0.254515,0,0.000318,0.000318,1
2806,2806,,2,3,3,6,4,4,8,11,0.242705,0.254515,0,0.000318,0.000318,1
2785,2785,,2,2,2,4,2,2,4,11,0.242705,0.254399,0,0.000313,0.000313,1
2804,2804,,2,3,3,6,4,4,8,11,0.242725,0.254573,0.000669,0.000313,0.000313,0.333333
2786,2786,,2,1,1,2,2,2,4,11,0.242664,0.254168,0,0.000308,0.000308,0
2787,2787,,2,1,1,2,2,2,4,11,0.242664,0.254168,0,0.000308,0.000308,0
2788,2788,,2,1,1,2,1,1,2,11,0.242664,0.254168,0,0.000308,0.000308,0
2796,2796,,2,1,1,2,1,1,2,11,0.242664,0.254168,0,0.000308,0.000308,0
2807,2807,,2,1,1,2,1,1,2,11,0.242664,0.254168,0,0.000308,0.000308,0
2809,2809,,2,1,1,2,2,2,4,11,0.242664,0.254168,0,0.000308,0.000308,0
6066,6066,,2,1,1,2,2,2,4,11,0.242664,0.254168,0,0.000308,0.000308,0
6067,6067,,2,1,1,2,2,2,4,11,0.242664,0.254168,0,0.000308,0.000308,0
2792,2792,,34,2,1,3,2,2,4,12,0.195528,0.201657,0,0.00001,0.000005,0
2810,2810,,2,1,1,2,1,1,2,12,0.19533,0.20138,0,0.000005,0.000005,0
2808,2808,,34,1,1,2,1,1,2,12,0.195993,0.202466,0,0.000005,0.000005,0
2821,2821,,2,5,5,10,9,9,18,10,0.262054,0.278861,0.000042,0.001582,0.001537,0.6
2850,2850,,2,7,7,14,12,12,24,10,0.289062,0.3091,0.000153,0.00058,0.00346,0.375
2856,2856,,2,5,5,10,8,8,16,10,0.244431,0.257572,0.000669,0.000513,0.000473,0.5
2822,2822,,2,1,1,2,2,2,4,10,0.244328,0.256821,0,0.000426,0.00043,0
2824,2824,,2,1,1,2,3,3,6,10,0.244328,0.256821,0,0.000426,0.00043,0
2830,2830,,2,1,1,2,1,1,2,11,0.196433,0.203046,0,0.000008,0.000008,0
2844,2844,,2,3,3,6,4,4,8,10,0.247195,0.261048,0,0.000864,0.000891,1
2852,2852,,2,3,3,6,5,5,10,10,0.24439,0.257225,0,0.000489,0.000447,1
2861,2861,,2,1,1,2,2,2,4,10,0.244328,0.256821,0,0.000426,0.00043,0
6072,6072,,2,1,1,2,1,1,2,10,0.244328,0.256821,0,0.000426,0.00043,0
2877,2877,,2,5,4,9,5,4,9,10,0.24246,0.255744,0.000001,0.000779,0.00085,0.6
2891,2891,,2,6,6,12,7,7,14,10,0.285912,0.305448,0,0.005504,0.005567,1
2893,2893,,2,6,7,13,7,8,15,10,0.243011,0.257009,0.000004,0.000696,0.001026,0.517857
2900,2900,,2,3,3,6,3,3,6,11,0.238315,0.250082,0,0.000685,0.000757,0.666667
2903,2903,,2,6,5,11,9,9,18,10,0.241871,0.254263,0.000004,0.000987,0.001106,0.6
2907,2907,,2,5,5,10,5,5,10,11,0.239006,0.251707,0,0.000659,0.000729,0.85
4146,4146,,2,1,1,2,1,1,2,11,0.230603,0.241043,0,0.000195,0.000231,0
6079,6079,,2,2,3,5,3,3,6,10,0.236868,0.24876,0,0.000478,0.000587,1
2905,2905,,2,2,2,4,2,2,4,11,0.237277,0.248231,0,0.000297,0.000338,1
4304,4304,,2,4,3,7,4,3,7,10,0.279705,0.296134,0,0.002236,0.002151,1
2879,2879,,2,2,2,4,4,4,8,10,0.212097,0.221606,0,0.000053,0.000052,1
6460,6460,,2,4,4,8,7,7,14,10,0.241911,0.254066,0.00011,0.000661,0.000715,0.416667
2883,2883,,2,17,15,32,21,20,41,10,0.291221,0.312334,0.000566,0.012051,0.00968,0.529412
2884,2884,,2,6,6,12,7,7,14,10,0.272753,0.292149,0,0.00401,0.004097,1
6080,6080,,2,3,3,6,3,3,6,11,0.235016,0.245705,0,0.000499,0.000534,1
6788,6788,,2,4,4,8,7,7,14,11,0.235035,0.245879,0,0.000516,0.00055,0.833333
2885,2885,,2,4,4,8,4,4,8,10,0.288744,0.306496,0,0.004651,0.004631,0.833333
2888,2888,,2,1,1,2,1,1,2,11,0.234978,0.245359,0,0.000335,0.000332,0
2889,2889,,2,3,3,6,3,3,6,10,0.283971,0.30149,0,0.002897,0.002869,1
2898,2898,,2,1,1,2,1,1,2,10,0.234634,0.245322,0,0.000283,0.00034,0
4249,4249,,2,1,1,2,1,1,2,10,0.234634,0.245322,0,0.000283,0.00034,0
2914,2914,,7,4,4,8,6,6,12,10,0.261959,0.280181,0,0.001841,0.001965,1
2917,2917,,7,3,3,6,4,4,8,10,0.261887,0.279893,0,0.001867,0.001867,1
2918,2918,,7,2,2,4,3,3,6,10,0.243339,0.256836,0,0.000684,0.000686,1
2920,2920,,7,6,6,12,9,9,18,10,0.262006,0.280528,0,0.002165,0.00216,1
4358,4358,,7,4,4,8,5,5,10,10,0.24338,0.257182,0,0.000845,0.000848,0.666667
4375,4375,,7,5,5,10,6,6,12,10,0.266507,0.285496,0.000075,0.002743,0.00274,0.4
6083,6083,,7,1,1,2,1,1,2,10,0.243154,0.256356,0,0.000437,0.000438,0
6086,6086,,7,3,3,6,6,6,12,10,0.261887,0.279893,0,0.001867,0.001867,1
6088,6088,,7,3,3,6,5,5,10,10,0.261887,0.279893,0,0.001867,0.001867,1
6085,6085,,7,2,2,4,2,2,4,11,0.231603,0.243243,0,0.000291,0.000292,0
2913,2913,,7,9,9,18,15,15,30,10,0.267247,0.287644,0.000018,0.003797,0.003798,0.597222
2937,2937,,7,14,13,27,18,18,36,10,0.289905,0.315104,0.000812,0.006793,0.006745,0.467033
4374,4374,,7,15,14,29,18,17,35,10,0.290547,0.315839,0.000053,0.009183,0.008776,0.604762
2962,2962,,7,10,10,20,13,13,26,10,0.267867,0.288245,0.000007,0.004218,0.004282,0.555556
2966,2966,,7,4,4,8,5,5,10,10,0.264819,0.282486,0,0.002869,0.002863,0.666667
2974,2974,,7,14,14,28,20,21,41,10,0.271241,0.292726,0.001073,0.005979,0.005975,0.505495
6089,6089,,7,4,4,8,5,5,10,10,0.267123,0.286466,0,0.004112,0.004093,1
2923,2923,,7,14,14,28,16,16,32,10,0.262578,0.283525,0.002704,0.002327,0.00233,0.252747
2926,2926,,7,4,4,8,5,5,10,10,0.260775,0.279113,0.000006,0.001528,0.001529,0.5
2930,2930,,7,8,8,16,10,10,20,10,0.2612,0.280274,0.000005,0.002172,0.002176,0.75
2938,2938,,7,2,2,4,2,2,4,10,0.259556,0.276739,0,0.00122,0.001218,1
6093,6093,,7,1,1,2,1,1,2,11,0.207985,0.217555,0,0.000037,0.000037,0
6094,6094,,7,1,1,2,1,1,2,11,0.207985,0.217555,0,0.000037,0.000037,0
6095,6095,,7,1,1,2,1,1,2,11,0.207985,0.217555,0,0.000037,0.000037,0
6490,6490,,7,1,1,2,1,1,2,11,0.207985,0.217555,0,0.000037,0.000037,0
2932,2932,,7,5,5,10,7,7,14,10,0.270529,0.290674,0.000003,0.003092,0.003094,0.8
3200,3200,,30,5,5,10,5,5,10,10,0.249978,0.265026,0.000006,0.001036,0.001043,0.4
7479,7479,,7,2,2,4,2,2,4,11,0.225857,0.237811,0,0.000253,0.000256,1
6755,6755,,7,1,1,2,1,1,2,11,0.224977,0.236226,0,0.000109,0.00011,0
7478,7478,,7,1,1,2,1,1,2,11,0.224977,0.236226,0,0.000109,0.00011,0
2955,2955,,7,3,3,6,3,3,6,10,0.26054,0.278535,0.000003,0.001522,0.001524,0.666667
2957,2957,,7,4,4,8,4,4,8,10,0.270808,0.291165,0.000004,0.003111,0.003115,0.5
3377,3377,,30,4,4,8,5,5,10,10,0.280167,0.299933,0.000002,0.002976,0.002956,0.5
2935,2935,,7,3,2,5,3,2,5,10,0.239542,0.253012,0.000006,0.001598,0.000414,0.333333
3366,3366,,30,4,4,8,7,7,14,10,0.269518,0.287827,0.000042,0.001469,0.001487,0.333333
2936,2936,,7,2,2,4,2,2,4,10,0.259977,0.277525,0.000003,0.001382,0.001382,0
6924,6924,,7,1,1,2,1,1,2,11,0.224766,0.23583,0,0.000108,0.000109,0
2972,2972,,7,8,8,16,10,10,20,10,0.271496,0.29231,0.000005,0.005534,0.005521,0.607143
6103,6103,,7,1,1,2,1,1,2,10,0.255557,0.270213,0,0.001323,0.00131,0
6105,6105,,7,6,6,12,7,7,14,10,0.259113,0.277495,0.000672,0.002819,0.002849,0.266667
7863,7863,,7,1,1,2,1,1,2,10,0.255557,0.270213,0,0.001323,0.00131,0
2958,2958,,7,3,3,6,5,5,10,10,0.270783,0.290445,0,0.003877,0.003875,0.666667
2968,2968,,7,8,8,16,10,10,20,10,0.271879,0.292697,0.000007,0.004849,0.004896,0.625
2973,2973,,7,6,7,13,8,9,17,10,0.271854,0.292524,0.000008,0.004334,0.00445,0.404762
2980,2980,,7,3,3,6,6,6,12,10,0.266212,0.284826,0,0.002962,0.002925,1
2981,2981,,7,4,4,8,6,6,12,10,0.266236,0.284999,0,0.003166,0.003129,1
2989,2989,,7,7,7,14,8,8,16,10,0.270986,0.291369,0.001727,0.00389,0.003888,0.142857
2991,2991,,7,4,4,8,6,5,11,10,0.265893,0.284422,0,0.002547,0.002589,0.916667
3769,3769,,7,3,2,5,5,4,9,10,0.270124,0.289605,0,0.003877,0.002772,0.666667
4111,4111,,7,13,13,26,16,15,31,10,0.272805,0.294667,0.00004,0.005861,0.005828,0.423077
4352,4352,,7,7,8,15,9,10,19,10,0.271266,0.292091,0.000005,0.004918,0.005085,0.732143
4364,4364,,7,10,10,20,13,14,27,10,0.265306,0.285045,0.000015,0.003598,0.003595,0.555556
6111,6111,,7,3,3,6,3,3,6,10,0.265038,0.283631,0.000003,0.002486,0.002484,0.666667
6147,6147,,7,18,18,36,30,30,60,10,0.267544,0.289377,0.000318,0.004538,0.004456,0.342105
6149,6149,,7,4,4,8,5,5,10,10,0.266236,0.284999,0,0.003166,0.003129,1
6150,6150,,7,5,5,10,7,7,14,10,0.26663,0.285611,0,0.003664,0.003626,1
6153,6153,,7,3,4,7,4,5,9,10,0.266236,0.284999,0,0.002962,0.002973,1
6158,6158,,7,2,2,4,2,2,4,10,0.264576,0.282562,0,0.002288,0.002284,1
6160,6160,,7,4,4,8,4,4,8,10,0.264625,0.282909,0,0.002581,0.002577,0.833333
6165,6165,,7,2,2,4,2,2,4,10,0.264576,0.282562,0,0.002288,0.002284,1
6485,6485,,7,4,3,7,6,5,11,10,0.266212,0.284826,0,0.00301,0.002925,1
2956,2956,,7,2,2,4,2,2,4,10,0.270124,0.289605,0,0.002772,0.002772,0
2961,2961,,7,3,2,5,3,2,5,10,0.242664,0.257776,0,0.001121,0.001019,0
2963,2963,,7,2,2,4,2,2,4,10,0.259977,0.277525,0.000003,0.001382,0.001382,0
3965,3965,,7,2,2,4,2,2,4,11,0.233779,0.245216,0,0.00046,0.000464,1
2967,2967,,7,3,4,7,4,5,9,10,0.271419,0.291332,0,0.003447,0.003837,0.833333
2969,2969,,7,1,1,2,2,2,4,10,0.259206,0.275989,0,0.001183,0.001181,0
6121,6121,,7,1,1,2,1,1,2,11,0.213383,0.223146,0,0.000096,0.000096,0
6138,6138,,7,2,2,4,2,2,4,11,0.214461,0.225207,0,0.000167,0.000169,1
4297,4297,,7,2,2,4,3,3,6,10,0.260563,0.277987,0,0.001574,0.001572,1
6143,6143,,7,7,7,14,8,8,16,10,0.261271,0.280025,0.000182,0.00202,0.00202,0.47619
6148,6148,,7,2,2,4,3,3,6,10,0.262435,0.280285,0,0.001857,0.001822,1
6151,6151,,7,3,3,6,3,3,6,10,0.263153,0.281746,0.000003,0.002056,0.002023,0.333333
6154,6154,,7,2,2,4,3,3,6,10,0.262435,0.280285,0,0.001857,0.001822,1
4371,4371,,7,5,5,10,5,5,10,10,0.263153,0.28047,0.000872,0.001666,0.001669,0.1
6734,6734,,7,1,1,2,1,1,2,10,0.262626,0.279026,0,0.001589,0.001591,0
7041,7041,,7,1,1,2,2,2,4,10,0.262626,0.279026,0,0.001589,0.001591,0
4363,4363,,7,2,2,4,2,2,4,10,0.259977,0.277525,0.000003,0.001382,0.001382,0
4368,4368,,7,3,3,6,3,3,6,11,0.218421,0.231938,0.000002,0.000268,0.00027,0.666667
4369,4369,,7,5,5,10,5,5,10,11,0.222702,0.237128,0.000009,0.00042,0.000422,0.3
6097,6097,,7,1,1,2,1,1,2,11,0.214111,0.226619,0,0.000199,0.000201,0
6102,6102,,7,1,1,2,1,1,2,11,0.214111,0.226619,0,0.000199,0.000201,0
6123,6123,,7,2,2,4,2,2,4,10,0.259977,0.277525,0.000003,0.001382,0.001382,0
6124,6124,,7,2,2,4,2,2,4,10,0.259977,0.277525,0.000003,0.001382,0.001382,0
6140,6140,,7,2,2,4,2,2,4,11,0.217009,0.230119,0,0.000231,0.000233,1
6142,6142,,7,2,2,4,2,2,4,11,0.216131,0.229173,0.000004,0.000225,0.000227,0
6990,6990,,7,1,1,2,1,1,2,11,0.214111,0.226619,0,0.000199,0.000201,0
4370,4370,,7,1,1,2,1,1,2,11,0.213225,0.222666,0,0.000062,0.000062,0
6159,6159,,7,1,1,2,1,1,2,11,0.213225,0.222666,0,0.000062,0.000062,0
2996,2996,,30,2,2,4,3,3,6,10,0.259813,0.275758,0,0.001779,0.001801,1
2999,2999,,30,1,1,2,1,1,2,10,0.248836,0.263264,0,0.000758,0.000778,0
3001,3001,,30,2,2,4,4,4,8,10,0.259813,0.275758,0,0.001779,0.001801,1
3008,3008,,30,4,4,8,6,7,13,10,0.25986,0.276104,0.000001,0.001841,0.001864,0.666667
3010,3010,,30,1,1,2,1,1,2,10,0.248836,0.263264,0,0.000758,0.000778,0
3019,3019,,30,1,1,2,2,2,4,10,0.248836,0.263264,0,0.000758,0.000778,0
3020,3020,,30,3,5,8,7,7,14,10,0.259906,0.276335,0,0.00207,0.002171,0.75
3023,3023,,30,2,3,5,2,3,5,10,0.2489,0.263668,0.000001,0.000775,0.00086,0.333333
3063,3063,,30,3,2,5,5,4,9,10,0.258463,0.273731,0,0.001972,0.001044,0.916667
3066,3066,,30,4,4,8,6,7,13,10,0.26,0.276422,0,0.002444,0.002459,1
3089,3089,,30,2,2,4,6,5,11,10,0.259813,0.275758,0,0.001779,0.001801,1
3112,3112,,30,4,3,7,14,13,27,10,0.258486,0.273904,0.000001,0.001826,0.001057,0.75
6761,6761,,30,2,2,4,2,2,4,10,0.248857,0.263437,0,0.000803,0.000824,1
3002,3002,,30,2,2,4,4,4,8,10,0.258463,0.273731,0,0.001051,0.001052,1
3009,3009,,30,1,1,2,1,1,2,10,0.25844,0.273557,0,0.001021,0.001023,0
3012,3012,,30,1,1,2,2,2,4,11,0.206822,0.214952,0,0.000033,0.000022,0
3084,3084,,30,4,4,8,8,8,16,10,0.260728,0.277588,0.000669,0.001347,0.002035,0.6
3042,3042,,30,5,5,10,6,6,12,10,0.260281,0.276999,0,0.00209,0.002835,0.866667
3022,3022,,30,1,1,2,1,1,2,10,0.25844,0.273557,0,0.001021,0.001023,0
3097,3097,,30,2,2,4,2,2,4,10,0.258509,0.273846,0.000006,0.001035,0.001035,0
6169,6169,,30,2,3,5,2,3,5,10,0.244431,0.257185,0.000669,0.000496,0.000488,0.25
7561,7561,,30,1,2,3,1,2,3,10,0.244411,0.257012,0,0.000488,0.000496,1
3120,3120,,30,11,11,22,14,14,28,10,0.274779,0.296693,0.002039,0.003152,0.003139,0.272727
3115,3115,,30,6,6,12,8,8,16,10,0.270503,0.289301,0.000021,0.001935,0.001914,0.533333
3116,3116,,30,5,5,10,5,5,10,10,0.248515,0.262601,0.000004,0.000579,0.000583,0.3
3196,3196,,30,9,9,18,11,11,22,10,0.268665,0.289571,0.00005,0.002457,0.002455,0.5
3038,3038,,30,4,4,8,9,9,18,10,0.236849,0.249004,0,0.000244,0.000244,1
3050,3050,,30,6,6,12,10,10,20,10,0.236887,0.249351,0.000001,0.000252,0.000252,0.666667
3055,3055,,30,5,5,10,5,5,10,10,0.236868,0.249177,0.000669,0.000244,0.000244,0.6
6173,6173,,30,12,13,25,30,30,60,10,0.275908,0.296181,0.001024,0.002654,0.002633,0.301282
3039,3039,,30,3,3,6,3,3,6,10,0.23681,0.248773,0,0.00024,0.00024,1
3040,3040,,30,5,5,10,11,11,22,10,0.275671,0.294738,0,0.002627,0.002606,1
3155,3155,,30,7,7,14,7,7,14,10,0.276172,0.296037,0.000003,0.00312,0.003086,0.809524
3048,3048,,30,2,2,4,3,3,6,10,0.240801,0.253307,0,0.000288,0.000288,1
3053,3053,,30,3,2,5,3,3,6,10,0.23679,0.2486,0,0.000239,0.000236,0.666667
3061,3061,,30,4,4,8,8,8,16,10,0.260917,0.277698,0.000002,0.001318,0.002081,0.7
3146,3146,,30,2,2,4,4,4,8,10,0.240881,0.254058,0,0.000568,0.00056,1
6172,6172,,30,1,2,3,1,2,3,10,0.236771,0.248542,0,0.000194,0.000197,1
6174,6174,,30,4,4,8,4,4,8,10,0.236829,0.248946,0,0.000244,0.000244,0.833333
6443,6443,,30,4,3,7,5,5,10,10,0.23681,0.248773,0.000334,0.00024,0.00024,0.583333
6175,6175,,30,1,1,2,1,1,2,11,0.191519,0.197826,0,0.000004,0.000004,0
3056,3056,,30,1,1,2,1,1,2,11,0.191494,0.197739,0,0.000042,0.000004,1
3068,3068,,30,2,2,4,4,4,8,11,0.229869,0.242341,0,0.00036,0.000354,1
3071,3071,,30,1,1,2,3,3,6,11,0.229832,0.24211,0,0.000261,0.000254,0
3177,3177,,30,9,8,17,11,10,21,10,0.279002,0.298975,0.000109,0.003774,0.003708,0.388889
3279,3279,,30,13,13,26,23,23,46,10,0.281534,0.303139,0.000118,0.004792,0.004765,0.512821
4030,4030,,30,30,30,60,75,75,150,10,0.289034,0.317211,0.000177,0.011038,0.011104,0.721839
4148,4148,,30,6,6,12,6,6,12,10,0.276755,0.296589,0.000001,0.003499,0.00349,0.8
4302,4302,,30,19,19,38,23,23,46,10,0.285206,0.309017,0.000018,0.008749,0.008769,0.675439
6351,6351,,30,14,14,28,15,15,30,10,0.278948,0.301047,0,0.006349,0.006359,0.923077
6354,6354,,30,2,2,4,2,2,4,10,0.268765,0.286675,0,0.001663,0.00166,1
6357,6357,,30,7,7,14,7,7,14,10,0.27774,0.29831,0,0.004704,0.004698,0.857143
6390,6390,,30,13,13,26,22,22,44,10,0.277847,0.299309,0.000013,0.005252,0.005281,0.717949
6392,6392,,30,32,32,64,56,56,112,10,0.279732,0.304685,0.00002,0.009174,0.009239,0.664315
6393,6393,,30,5,5,10,5,5,10,10,0.278814,0.298951,0.000003,0.00429,0.003681,0.766667
3080,3080,,30,1,1,2,1,1,2,10,0.258463,0.273615,0.000334,0,0.001023,0.5
3085,3085,,30,1,1,2,1,1,2,10,0.25844,0.273557,0,0.001021,0.001023,0
3092,3092,,30,1,1,2,1,1,2,10,0.25844,0.273557,0,0.001021,0.001023,0
3094,3094,,30,1,1,2,1,1,2,10,0.25844,0.273557,0,0.001021,0.001023,0
3100,3100,,30,3,4,7,12,12,24,10,0.25986,0.276104,0.000001,0.001055,0.001847,0.75
3101,3101,,30,1,1,2,1,1,2,11,0.205409,0.212925,0.000334,0.001021,0,0.5
3103,3103,,30,2,2,4,2,2,4,10,0.258486,0.273788,0.000669,0.001021,0.001023,0
3104,3104,,30,3,3,6,5,6,11,10,0.258486,0.273904,0,0.001067,0.001069,1
3106,3106,,30,1,1,2,1,1,2,11,0.205409,0.212925,0,0.000016,0.000016,0
3931,3931,,30,13,14,27,17,19,36,10,0.287765,0.310657,0.00212,0.004931,0.004979,0.340659
3118,3118,,30,2,2,4,2,2,4,10,0.269543,0.287049,0.000014,0.00133,0.001306,0
4081,4081,,30,1,1,2,1,1,2,11,0.215566,0.225624,0,0.00005,0.000051,0
4142,4142,,30,1,1,2,1,1,2,11,0.215566,0.225624,0,0.00005,0.000051,0
4143,4143,,30,1,1,2,1,1,2,11,0.215566,0.225624,0,0.00005,0.000051,0
3122,3122,,30,1,1,2,2,2,4,11,0.231658,0.243808,0,0.000239,0.000234,0
3127,3127,,30,1,1,2,3,3,6,11,0.231658,0.243808,0,0.000239,0.000234,0
3128,3128,,30,1,1,2,1,1,2,11,0.231658,0.243808,0,0.000239,0.000234,0
3129,3129,,30,2,2,4,3,3,6,11,0.231677,0.243981,0,0.000243,0.000238,1
4097,4097,,30,9,9,18,13,13,26,11,0.242664,0.259675,0.000697,0.001198,0.00121,0.277778
4172,4172,,30,1,1,2,1,1,2,11,0.231658,0.243808,0,0.000239,0.000234,0
4175,4175,,30,1,1,2,1,1,2,11,0.231658,0.243808,0,0.000239,0.000234,0
4177,4177,,30,1,1,2,1,1,2,11,0.231658,0.243808,0,0.000239,0.000234,0
4183,4183,,30,2,2,4,2,2,4,11,0.231677,0.243981,0,0.000243,0.000238,1
4188,4188,,30,1,1,2,2,2,4,11,0.231658,0.243808,0,0.000239,0.000234,0
6179,6179,,30,1,1,2,1,1,2,11,0.231658,0.243808,0,0.000239,0.000234,0
6180,6180,,30,1,1,2,2,2,4,11,0.231658,0.243808,0,0.000239,0.000234,0
6182,6182,,30,1,1,2,2,2,4,11,0.231658,0.243808,0,0.000239,0.000234,0
3130,3130,,30,2,2,4,2,2,4,10,0.241526,0.253806,0,0.000573,0.000581,1
3151,3151,,30,1,1,2,1,1,2,10,0.237746,0.248933,0,0.000291,0.000291,0
3142,3142,,30,1,1,2,2,2,4,10,0.239145,0.250922,0,0.000375,0.000367,0
4235,4235,,30,2,3,5,2,3,5,10,0.243216,0.255814,0,0.000544,0.000526,0.666667
6183,6183,,30,2,1,3,2,1,3,10,0.243175,0.255468,0,0.000544,0.000509,1
6184,6184,,30,1,1,2,1,1,2,10,0.243175,0.255468,0,0.000535,0.000509,0
6185,6185,,30,2,2,4,2,2,4,10,0.243195,0.255641,0,0.000544,0.000518,1
3157,3157,,30,17,17,34,24,24,48,11,0.238414,0.254585,0.005364,0.000493,0.000542,0.044118
3170,3170,,30,1,1,2,1,1,2,12,0.192528,0.200361,0,0.000009,0.000008,0
3181,3181,,30,5,5,10,7,7,14,10,0.27604,0.296166,0.000366,0.00318,0.003155,0.7
3182,3182,,30,1,1,2,2,2,4,12,0.192528,0.200361,0,0.000009,0.000008,0
3183,3183,,30,4,4,8,5,5,10,10,0.270073,0.288261,0.000141,0.001655,0.001677,0.833333
3184,3184,,30,1,1,2,1,1,2,12,0.192528,0.200361,0,0.000009,0.000008,0
3186,3186,,30,1,1,2,1,1,2,12,0.192528,0.200361,0,0.000009,0.000008,0
3932,3932,,30,2,2,4,4,4,8,10,0.269972,0.287799,0.000141,0.001329,0.001305,0
3933,3933,,30,2,2,4,3,3,6,10,0.269972,0.287799,0.000141,0.001329,0.001305,0
3936,3936,,30,1,1,2,1,1,2,12,0.192528,0.200361,0,0.000009,0.000008,0
3937,3937,,30,3,3,6,4,4,8,10,0.270022,0.28803,0.000141,0.001575,0.001598,0.666667
4000,4000,,30,2,2,4,3,3,6,10,0.269972,0.287799,0.000141,0.001329,0.001305,0
4131,4131,,30,2,2,4,2,2,4,11,0.223704,0.234501,0,0.000089,0.000087,1
4132,4132,,30,1,1,2,1,1,2,12,0.192528,0.200361,0,0.000009,0.000008,0
4133,4133,,30,1,1,2,1,1,2,12,0.192528,0.200361,0,0.000009,0.000008,0
6186,6186,,30,1,1,2,1,1,2,12,0.192528,0.200361,0,0.000009,0.000008,0
3161,3161,,30,2,2,4,2,2,4,11,0.237238,0.250363,0,0.000305,0.000354,1
3163,3163,,30,1,1,2,1,1,2,11,0.212331,0.22075,0,0.000021,0.000021,0
3939,3939,,30,2,2,4,2,2,4,10,0.269543,0.287049,0.000669,0.001321,0.001297,0
3173,3173,,30,1,1,2,1,1,2,10,0.269493,0.286818,0,0.001321,0.001297,0
3174,3174,,30,4,4,8,5,5,10,10,0.275539,0.295184,0.000001,0.003151,0.003129,0.833333
3408,3408,,30,14,14,28,15,15,30,10,0.265428,0.284269,0.0007,0.00139,0.001384,0.175824
4135,4135,,30,2,2,4,2,2,4,10,0.269594,0.287135,0,0.00138,0.001357,1
4153,4153,,30,3,3,6,5,5,10,10,0.249051,0.263091,0,0.00075,0.000755,1
6187,6187,,30,3,3,6,5,5,10,10,0.249051,0.263091,0,0.00075,0.000755,1
6194,6194,,30,3,3,6,5,5,10,10,0.249051,0.263091,0,0.00075,0.000755,1
4082,4082,,30,2,2,4,3,3,6,10,0.249029,0.262918,0,0.000711,0.000716,1
4154,4154,,30,2,2,4,2,2,4,10,0.249029,0.262918,0,0.000711,0.000716,1
4157,4157,,30,1,1,2,1,1,2,10,0.245304,0.257837,0,0.000355,0.000357,0
4158,4158,,30,1,1,2,1,1,2,10,0.245304,0.257837,0,0.000355,0.000357,0
6191,6191,,30,2,2,4,2,2,4,10,0.245366,0.258126,0.000001,0.000361,0.000363,0
6192,6192,,30,1,1,2,1,1,2,10,0.245304,0.257837,0,0.000355,0.000357,0
6193,6193,,30,2,2,4,2,2,4,10,0.249029,0.262918,0,0.000711,0.000716,1
6195,6195,,30,2,2,4,3,3,6,10,0.249029,0.262918,0,0.000711,0.000716,1
4155,4155,,30,2,2,4,2,2,4,10,0.247768,0.261047,0,0.000362,0.000365,1
4168,4168,,30,3,3,6,4,4,8,10,0.247789,0.26122,0.000003,0.000368,0.000371,0.333333
6188,6188,,30,1,1,2,2,2,4,10,0.247725,0.260816,0,0.000356,0.000359,0
6190,6190,,30,1,1,2,1,1,2,10,0.247725,0.260816,0,0.000356,0.000359,0
3213,3213,,35,7,7,14,12,13,25,11,0.22353,0.235389,0.001125,0.000104,0.000105,0.25
3215,3215,,35,3,3,6,3,3,6,11,0.223409,0.234523,0.000331,0.000096,0.000097,0.666667
3220,3220,,35,1,1,2,1,1,2,12,0.182704,0.188837,0,0.000002,0.000002,0
3222,3222,,35,9,9,18,16,15,31,11,0.235457,0.25077,0.002161,0.000395,0.000394,0.194444
3227,3227,,35,2,2,4,2,2,4,12,0.182716,0.18901,0,0.000003,0.000003,1
3236,3236,,30,4,3,7,7,6,13,11,0.223357,0.23435,0.000001,0.000099,0.000098,0.5
3237,3237,,35,2,2,4,3,3,6,12,0.190659,0.198534,0,0.000008,0.000008,1
3217,3217,,30,2,2,4,2,2,4,11,0.22334,0.234176,0,0.000096,0.000097,1
3224,3224,,35,4,4,8,6,6,12,11,0.223461,0.234812,0.000786,0.000101,0.000102,0.333333
4001,4001,,35,2,3,5,6,8,14,11,0.223461,0.234696,0,0.000101,0.000103,1
4152,4152,,35,1,1,2,1,1,2,12,0.190596,0.198129,0,0.000006,0.000006,0
6196,6196,,35,2,2,4,2,2,4,12,0.190621,0.19836,0,0.000008,0.000008,1
6787,6787,,35,1,2,3,1,2,3,11,0.223409,0.234407,0,0.000006,0.000101,1
3223,3223,,30,3,3,6,3,3,6,11,0.223357,0.23435,0,0.000098,0.000098,1
6197,6197,,30,4,4,8,4,4,8,11,0.223375,0.234523,0,0.000099,0.0001,0.666667
6200,6200,,30,3,3,6,3,3,6,11,0.223357,0.23435,0,0.000098,0.000098,1
3232,3232,,35,1,1,2,2,2,4,12,0.182658,0.188635,0,0.000002,0.000002,0
3235,3235,,30,2,2,4,4,3,7,11,0.22334,0.234176,0,0.000096,0.000097,1
6198,6198,,30,2,2,4,2,2,4,11,0.22334,0.234176,0,0.000096,0.000097,1
6199,6199,,30,1,1,2,1,1,2,11,0.223323,0.234003,0,0.000094,0.000095,0
3240,3240,,30,14,14,28,32,33,65,10,0.263538,0.283463,0.002372,0.001466,0.001474,0.208791
3241,3241,,30,2,2,4,4,4,8,11,0.208616,0.218102,0,0.000024,0.000024,1
3243,3243,,30,3,3,6,4,4,8,11,0.234082,0.246783,0.000064,0.000211,0.000212,0.666667
3244,3244,,30,5,5,10,9,8,17,11,0.212612,0.222899,0.00067,0.00005,0.00005,0.3
3247,3247,,30,1,1,2,3,3,6,11,0.208586,0.217871,0,0.000024,0.000024,0
3249,3249,,30,2,2,4,4,4,8,11,0.238315,0.251681,0,0.000331,0.000329,1
3250,3250,,30,6,6,12,10,10,20,10,0.266334,0.284517,0.001051,0.001393,0.001384,0.466667
3253,3253,,30,2,2,4,3,3,6,11,0.21255,0.222322,0,0.000046,0.000046,1
3256,3256,,30,3,3,6,4,4,8,11,0.238355,0.251912,0.000669,0.000331,0.000329,0.333333
3890,3890,,30,2,2,4,4,4,8,11,0.238315,0.251681,0,0.000331,0.000329,1
3919,3919,,30,10,10,20,18,18,36,10,0.269543,0.289565,0.003315,0.002239,0.002239,0.327273
3246,3246,,30,1,1,2,1,1,2,12,0.175345,0.180931,0,0.000001,0.000001,0
6212,6212,,30,1,1,2,1,1,2,12,0.19249,0.1994,0,0.000005,0.000005,0
3261,3261,,36,0,1,1,0,1,1,1,1,1,0,0,0,0
3260,3260,,36,1,0,1,1,0,1,0,0,0,0,0,0,0
3262,3262,,30,2,2,4,4,4,8,10,0.260469,0.27714,0,0.000837,0.000845,1
3263,3263,,30,9,9,18,19,19,38,10,0.26869,0.2877,0.000012,0.002214,0.002217,0.527778
3266,3266,,30,5,5,10,7,7,14,10,0.26859,0.287007,0.000002,0.001932,0.001934,0.9
3267,3267,,30,3,3,6,5,5,10,10,0.26054,0.277399,0,0.000855,0.000863,1
3303,3303,,30,7,7,14,9,9,18,10,0.260846,0.278526,0.000004,0.001115,0.001124,0.571429
3270,3270,,30,2,2,4,3,3,6,10,0.260563,0.277284,0,0.00091,0.000919,1
3271,3271,,30,2,2,4,4,4,8,10,0.260563,0.277284,0,0.00091,0.000919,1
4141,4141,,30,2,2,4,4,4,8,10,0.260563,0.277284,0,0.00091,0.000919,1
3273,3273,,30,6,6,12,13,13,26,10,0.269091,0.288179,0.000026,0.002185,0.002185,0.733333
3903,3903,,30,6,6,12,12,12,24,11,0.238552,0.252807,0.000003,0.000552,0.000551,0.6
3278,3278,,30,4,4,8,8,8,16,10,0.261035,0.278629,0.00001,0.001194,0.001201,0.833333
3284,3284,,37,2,2,4,4,4,8,11,0.238256,0.251508,0.001337,0.000307,0.000305,0
3287,3287,,30,1,1,2,3,3,6,11,0.238178,0.25119,0,0.000307,0.000305,0
3288,3288,,30,1,1,2,3,3,6,11,0.238178,0.25119,0,0.000307,0.000305,0
3289,3289,,30,3,3,6,5,5,10,10,0.268991,0.287601,0,0.002078,0.002077,1
3294,3294,,30,4,4,8,5,5,10,10,0.261035,0.278629,0,0.001288,0.001294,1
3894,3894,,30,1,1,2,2,2,4,11,0.238178,0.25119,0,0.000307,0.000305,0
3898,3898,,30,6,6,12,14,14,28,10,0.269468,0.28886,0.00003,0.002307,0.002308,0.733333
3901,3901,,30,2,2,4,5,5,10,11,0.238217,0.251421,0,0.000315,0.000313,1
3904,3904,,30,1,1,2,1,1,2,11,0.238178,0.25119,0,0.000307,0.000305,0
3905,3905,,30,1,1,2,3,3,6,11,0.238178,0.25119,0,0.000307,0.000305,0
3908,3908,,30,6,6,12,11,11,22,11,0.238434,0.252432,0.000056,0.000477,0.000476,0.466667
3911,3911,,30,2,2,4,4,4,8,11,0.238256,0.251508,0,0.000399,0.000397,1
3923,3923,,30,4,4,8,7,7,14,10,0.266334,0.284217,0,0.001554,0.001546,1
3929,3929,,30,3,3,6,5,5,10,10,0.268991,0.287601,0,0.002078,0.002077,1
6223,6223,,30,1,1,2,3,3,6,11,0.238178,0.25119,0,0.000307,0.000305,0
3896,3896,,30,5,5,10,6,6,12,10,0.26894,0.287688,0,0.002124,0.002128,0.9
3282,3282,,37,2,2,4,2,2,4,12,0.192451,0.199458,0.000669,0.000005,0.000005,0
3910,3910,,37,1,1,2,1,1,2,13,0.1614,0.165521,0,0,0,0
3296,3296,,30,2,2,4,3,3,6,10,0.260634,0.277515,0.000002,0.000824,0.000832,0
3298,3298,,30,3,3,6,4,4,8,10,0.260658,0.277688,0.000002,0.000926,0.000934,0.666667
3299,3299,,30,3,3,6,3,3,6,10,0.26854,0.28666,0,0.001873,0.001874,1
3300,3300,,30,1,1,2,1,1,2,11,0.209769,0.218539,0,0.000022,0.000022,0
3302,3302,,30,1,1,2,1,1,2,10,0.264868,0.281439,0,0.000969,0.000962,0
3305,3305,,30,4,4,8,8,8,16,10,0.268615,0.286949,0.000002,0.001895,0.001896,0.833333
3307,3307,,30,4,4,8,5,5,10,10,0.268615,0.286949,0.000002,0.001895,0.001896,0.833333
3310,3310,,30,2,2,4,2,2,4,10,0.26555,0.282618,0,0.001018,0.001011,1
3407,3407,,30,2,2,4,2,2,4,10,0.265014,0.281901,0,0.000991,0.000984,1
4013,4013,,30,2,2,4,2,2,4,10,0.265014,0.281901,0,0.000991,0.000984,1
3318,3318,,30,1,1,2,1,1,2,11,0.220507,0.230756,0,0.000067,0.000067,0
3319,3319,,30,4,4,8,5,5,10,10,0.252295,0.267064,0,0.000823,0.000841,1
3324,3324,,30,8,8,16,8,8,16,11,0.245638,0.260307,0.004102,0.000386,0.000387,0.25
3326,3326,,30,3,3,6,4,4,8,10,0.252096,0.266457,0,0.000772,0.000773,1
3328,3328,,30,1,1,2,2,2,4,11,0.244162,0.256455,0,0.000194,0.000194,0
3329,3329,,30,4,4,8,4,4,8,10,0.252185,0.266775,0,0.00079,0.000791,1
3330,3330,,30,11,11,22,15,15,30,10,0.255874,0.272972,0.001928,0.001122,0.001123,0.4
3332,3332,,30,6,6,12,8,8,16,10,0.252493,0.267843,0.000152,0.000793,0.00081,0.666667
3336,3336,,30,5,5,10,10,10,20,10,0.252229,0.266937,0.000001,0.000849,0.00085,0.9
3337,3337,,30,4,4,8,6,6,12,10,0.252185,0.266775,0.00074,0.000772,0.000773,0.5
3345,3345,,30,7,7,14,9,9,18,10,0.252405,0.267699,0.000029,0.000969,0.000969,0.761905
3349,3349,,30,6,6,12,8,8,16,11,0.250651,0.266481,0.000002,0.000829,0.00083,0.866667
3355,3355,,30,11,11,22,16,16,32,10,0.253003,0.269507,0.000012,0.001149,0.001166,0.6
3356,3356,,30,3,3,6,3,3,6,10,0.252096,0.266457,0,0.000772,0.000773,1
3362,3362,,30,1,1,2,1,1,2,11,0.244162,0.256455,0,0.000194,0.000194,0
4319,4319,,30,10,10,20,15,15,30,10,0.252825,0.269056,0.000057,0.001071,0.001089,0.6
4320,4320,,30,6,7,13,9,9,18,10,0.252273,0.267283,0.000001,0.000858,0.000875,0.666667
6242,6242,,30,3,3,6,5,5,10,10,0.252096,0.266457,0,0.000772,0.000773,1
6269,6269,,30,1,1,2,1,1,2,11,0.244162,0.256455,0,0.000194,0.000194,0
6300,6300,,30,1,1,2,1,1,2,11,0.244162,0.256455,0,0.000194,0.000194,0
6308,6308,,30,4,4,8,4,4,8,10,0.25181,0.266036,0.000004,0.000538,0.000539,0.666667
7128,7128,,48,3,3,6,3,3,6,11,0.244431,0.2572,0.004,0.000194,0.000194,0
4010,4010,,30,2,1,3,3,3,6,10,0.250608,0.26387,0,0.000392,0.000326,1
6237,6237,,30,2,1,3,2,1,3,11,0.220507,0.230756,0,0.000068,0.000067,1
6260,6260,,30,1,1,2,1,1,2,12,0.180703,0.186369,0,0.000067,0.000001,1
6281,6281,,30,2,2,4,2,2,4,11,0.220524,0.230929,0,0.000068,0.000068,1
6286,6286,,30,2,2,4,2,2,4,11,0.220524,0.230929,0.000334,0.000067,0.000068,0.5
6309,6309,,38,2,2,4,2,2,4,11,0.220592,0.231131,0.0007,0.000067,0.000067,0
6319,6319,,30,2,2,4,2,2,4,11,0.220524,0.230929,0,0.000068,0.000068,1
3323,3323,,48,2,2,4,2,2,4,12,0.196527,0.203272,0.001332,0.000003,0.000003,0
6322,6322,,48,2,2,4,2,2,4,13,0.164323,0.168567,0.000665,0,0,0
6248,6248,,48,2,2,4,2,2,4,12,0.197306,0.204759,0.001339,0.000006,0.000006,0
6262,6262,,38,3,3,6,3,3,6,12,0.197279,0.204898,0.000636,0.000006,0.000006,0.333333
6276,6276,,30,2,2,4,2,2,4,12,0.197252,0.204667,0.000129,0.000006,0.000006,0
3325,3325,,30,2,2,4,6,6,12,10,0.250978,0.264754,0,0.000578,0.000579,1
6275,6275,,30,2,2,4,2,2,4,11,0.203799,0.212113,0.000539,0.000018,0.000018,0
6289,6289,,30,1,1,2,1,1,2,11,0.203756,0.211824,0,0.000018,0.000018,0
6321,6321,,30,3,3,6,3,3,6,11,0.217811,0.228648,0.000596,0.000064,0.000081,0.333333
3333,3333,,30,4,4,8,5,5,10,10,0.251022,0.2651,0,0.000607,0.000607,0.833333
3363,3363,,30,3,3,6,3,3,6,10,0.251,0.264927,0,0.000588,0.000589,1
3334,3334,,30,2,2,4,2,2,4,12,0.17891,0.185033,0.000001,0.000002,0.000001,0
6267,6267,,30,2,2,4,2,2,4,11,0.201466,0.208862,0.000073,0.000012,0.000012,0
3346,3346,,30,2,2,4,3,3,6,11,0.244121,0.258115,0,0.000417,0.000416,1
4291,4291,,30,2,2,4,4,4,8,10,0.250978,0.264754,0,0.000578,0.000579,1
6271,6271,,30,3,3,6,3,3,6,10,0.251,0.264927,0.000001,0.000584,0.000584,0.666667
6278,6278,,30,1,1,2,1,1,2,11,0.242603,0.255816,0,0.000253,0.000253,0
6294,6294,,30,3,3,6,3,3,6,10,0.251,0.264927,0.000001,0.000584,0.000584,0.666667
6298,6298,,30,2,2,4,3,3,6,11,0.242827,0.256538,0,0.000305,0.000322,1
6303,6303,,30,2,2,4,2,2,4,11,0.242827,0.256538,0,0.000305,0.000322,1
6338,6338,,30,1,1,2,1,1,2,11,0.242603,0.255816,0,0.000253,0.000253,0
4051,4051,,30,1,1,2,1,1,2,11,0.217729,0.228157,0,0.000051,0.000068,0
6241,6241,,30,3,3,6,3,3,6,10,0.250869,0.264765,0.000001,0.000382,0.000399,0.666667
6253,6253,,30,1,1,2,1,1,2,11,0.217729,0.228157,0,0.000051,0.000068,0
6256,6256,,30,1,1,2,1,1,2,11,0.217729,0.228157,0,0.000051,0.000068,0
6312,6312,,30,1,1,2,1,1,2,11,0.217729,0.228157,0,0.000051,0.000068,0
6318,6318,,30,1,1,2,1,1,2,11,0.217729,0.228157,0,0.000051,0.000068,0
6334,6334,,30,1,1,2,1,1,2,11,0.217729,0.228157,0,0.000051,0.000068,0
3348,3348,,30,4,4,8,4,4,8,11,0.234234,0.246198,0,0.000199,0.000198,0.666667
3347,3347,,30,3,3,6,6,6,12,11,0.235477,0.248127,0,0.00023,0.000229,1
6268,6268,,30,2,2,4,2,2,4,11,0.234196,0.245852,0,0.000166,0.000165,1
3353,3353,,30,2,2,4,2,2,4,11,0.234196,0.245852,0,0.000166,0.000165,1
6235,6235,,30,1,1,2,1,1,2,11,0.234177,0.245679,0,0.000163,0.000162,0
6266,6266,,30,1,2,3,1,2,3,11,0.234215,0.24591,0.000334,0.000163,0.000162,0.5
6310,6310,,30,1,1,2,2,2,4,11,0.234177,0.245679,0,0.000163,0.000162,0
6315,6315,,30,2,2,4,2,2,4,11,0.234196,0.245852,0,0.000166,0.000165,1
3358,3358,,30,2,2,4,2,2,4,10,0.25063,0.264043,0,0.000331,0.000332,1
3360,3360,,30,2,2,4,2,2,4,12,0.169505,0.17458,0,0,0,0
4052,4052,,30,1,1,2,1,1,2,10,0.250608,0.26387,0,0.000325,0.000326,0
6249,6249,,30,2,2,4,2,2,4,10,0.25063,0.264043,0,0.00033,0.000331,1
6252,6252,,30,1,1,2,1,1,2,10,0.250608,0.26387,0,0.000325,0.000326,0
6261,6261,,30,1,1,2,1,1,2,10,0.250608,0.26387,0,0.000325,0.000326,0
6287,6287,,30,1,1,2,1,1,2,10,0.250608,0.26387,0,0.000325,0.000326,0
6302,6302,,30,2,2,4,2,2,4,10,0.25063,0.264043,0,0.000334,0.000335,1
6307,6307,,30,2,2,4,2,2,4,10,0.25063,0.264043,0,0.000334,0.000335,1
6317,6317,,30,2,2,4,2,2,4,10,0.25063,0.264043,0,0.00033,0.000331,1
6320,6320,,30,1,1,2,1,1,2,10,0.250608,0.26387,0,0.000325,0.000326,0
6793,6793,,30,1,1,2,1,1,2,10,0.250608,0.26387,0,0.000325,0.000326,0
6794,6794,,30,2,2,4,2,2,4,10,0.250651,0.264101,0.000669,0.000325,0.000326,0
6808,6808,,30,2,2,4,2,2,4,10,0.25063,0.264043,0,0.000334,0.000334,1
4033,4033,,30,10,9,19,20,20,40,10,0.274309,0.294337,0.000004,0.003815,0.003643,0.777778
4085,4085,,30,17,17,34,37,37,74,10,0.276914,0.299575,0.00001,0.00566,0.005732,0.764706
4109,4109,,30,17,17,34,20,20,40,10,0.275041,0.296733,0.00001,0.004817,0.004857,0.625
4110,4110,,30,5,5,10,6,6,12,10,0.275355,0.295365,0,0.003466,0.003464,0.9
4301,4301,,30,4,4,8,9,9,18,10,0.270022,0.288595,0,0.002106,0.002125,1
4334,4334,,30,5,5,10,6,6,12,10,0.276093,0.295775,0,0.003815,0.003797,1
5475,5475,,30,6,6,12,6,6,12,10,0.272908,0.291813,0.000001,0.002162,0.002725,0.595238
6342,6342,,30,4,4,8,6,6,12,10,0.269594,0.287942,0,0.001814,0.001815,0.666667
6343,6343,,30,7,7,14,8,8,16,10,0.273399,0.292783,0.000007,0.002662,0.002679,0.714286
6344,6344,,30,4,4,8,4,4,8,10,0.269669,0.288058,0,0.001691,0.001709,1
6345,6345,,30,30,30,60,56,56,112,10,0.275014,0.298679,0.000072,0.005585,0.005679,0.367816
6346,6346,,30,8,8,16,10,10,20,10,0.274648,0.294793,0.000008,0.0037,0.003738,0.714286
6348,6348,,30,2,2,4,3,3,6,10,0.269317,0.287134,0,0.001411,0.00141,1
6349,6349,,30,2,2,4,2,2,4,10,0.269317,0.287134,0,0.001411,0.00141,1
6350,6350,,30,2,2,4,3,3,6,10,0.269317,0.287134,0,0.001411,0.00141,1
6352,6352,,30,5,5,10,5,5,10,10,0.273944,0.293309,0,0.002642,0.002638,0.9
6353,6353,,30,11,11,22,16,16,32,10,0.275014,0.295734,0.000001,0.004567,0.004583,0.836364
6355,6355,,30,15,15,30,23,23,46,10,0.272727,0.294139,0.000001,0.004911,0.004899,0.828571
6356,6356,,30,10,10,20,11,11,22,10,0.274962,0.295532,0,0.004604,0.004596,0.955556
6360,6360,,30,4,4,8,4,4,8,10,0.274282,0.29358,0,0.003172,0.003171,0.833333
6361,6361,,30,9,9,18,11,11,22,10,0.275014,0.295503,0,0.004302,0.004315,0.916667
6366,6366,,30,12,12,24,21,21,42,10,0.274622,0.296651,0.001384,0.004016,0.004031,0.560606
6367,6367,,30,3,3,6,4,4,8,10,0.269619,0.287884,0.000005,0.001574,0.001595,0.666667
6368,6368,,30,5,5,10,6,6,12,10,0.269669,0.288231,0.000005,0.001826,0.001867,0.6
6379,6379,,30,8,8,16,8,8,16,10,0.273425,0.292956,0,0.003301,0.003316,0.928571
6380,6380,,30,4,4,8,4,4,8,10,0.272908,0.291582,0,0.002348,0.002345,0.833333
6381,6381,,30,4,4,8,4,4,8,10,0.272882,0.291524,0,0.002393,0.00239,1
6383,6383,,30,9,9,18,9,9,18,10,0.273451,0.29313,0.000005,0.003035,0.003055,0.694444
6384,6384,,30,5,5,10,7,7,14,10,0.272959,0.291813,0,0.002549,0.002544,0.9
6387,6387,,30,10,10,20,11,11,22,10,0.277767,0.298806,0,0.004707,0.004681,0.955556
6388,6388,,30,3,3,6,3,3,6,10,0.274204,0.293291,0,0.002916,0.002915,1
6391,6391,,30,6,6,12,6,6,12,10,0.271624,0.291384,0,0.00317,0.003186,0.933333
6394,6394,,30,5,5,10,5,5,10,10,0.273866,0.293135,0,0.002658,0.002658,0.8
6395,6395,,30,7,7,14,8,8,16,10,0.271547,0.291384,0.000008,0.003199,0.003195,0.619048
6397,6397,,30,4,4,8,4,4,8,10,0.274282,0.29358,0,0.003172,0.003171,0.833333
6398,6398,,30,3,3,6,3,3,6,10,0.272753,0.29112,0,0.00222,0.00222,1
6399,6399,,30,5,5,10,5,5,10,10,0.273944,0.293309,0,0.002642,0.002638,0.9
6400,6400,,30,15,15,30,15,15,30,10,0.27491,0.296179,0.000001,0.005231,0.005285,0.857143
6401,6401,,30,4,4,8,4,4,8,10,0.272908,0.291582,0,0.002348,0.002345,0.833333
6403,6403,,30,7,7,14,7,7,14,10,0.275539,0.295942,0,0.00401,0.00403,1
6411,6411,,30,3,3,6,4,4,8,10,0.271164,0.290085,0,0.002519,0.00254,1
6413,6413,,30,3,3,6,4,4,8,10,0.271164,0.290085,0,0.002519,0.00254,1
6414,6414,,30,5,5,10,9,9,18,10,0.275513,0.294879,0,0.002868,0.002853,0.9
6427,6427,,30,3,3,6,3,3,6,10,0.272856,0.291351,0,0.002092,0.002089,1
6428,6428,,30,5,5,10,5,5,10,10,0.270149,0.289028,0,0.002377,0.002373,1
6430,6430,,30,11,11,22,12,12,24,10,0.273529,0.293534,0,0.003955,0.003966,0.909091
6431,6431,,30,19,19,38,35,36,71,10,0.276994,0.299979,0.00024,0.005957,0.006032,0.725146
6433,6433,,30,2,2,4,2,2,4,10,0.271139,0.289911,0,0.002312,0.002312,1
6434,6434,,30,11,11,22,13,13,26,10,0.271751,0.29225,0.000008,0.003876,0.003938,0.709091
6772,6772,,30,1,1,2,1,1,2,10,0.269191,0.286758,0,0.00132,0.00132,0
6944,6944,,30,5,5,10,5,5,10,10,0.273321,0.292379,0,0.002618,0.002617,0.9
6954,6954,,30,4,4,8,5,5,10,10,0.269694,0.288115,0.000005,0.001622,0.001621,0.5
6955,6955,,30,3,3,6,4,4,8,10,0.269493,0.287596,0,0.001613,0.001633,1
7898,7898,,30,6,6,12,6,6,12,10,0.274543,0.294331,0,0.00341,0.003448,0.733333
6341,6341,,30,26,26,52,26,26,52,10,0.260822,0.283405,0.000741,0.003206,0.003216,0.212308
7503,7503,,30,5,5,10,5,5,10,10,0.257334,0.274778,0,0.001305,0.001302,0.7
6359,6359,,30,6,6,12,6,6,12,10,0.257633,0.275263,0,0.001558,0.001575,0.666667
6385,6385,,30,11,11,22,12,12,24,10,0.259346,0.278999,0.000001,0.002715,0.002749,0.781818
7508,7508,,30,1,1,2,1,1,2,10,0.255263,0.271041,0,0.000604,0.000603,0
7519,7519,,30,3,3,6,3,3,6,11,0.236693,0.252306,0,0.000683,0.000679,1
6382,6382,,30,4,4,8,4,4,8,11,0.24181,0.257431,0,0.000777,0.000774,0.5
6743,6743,,30,2,2,4,2,2,4,11,0.228739,0.242122,0,0.000362,0.000382,1
6358,6358,,30,1,1,2,2,2,4,11,0.222599,0.234177,0,0.0002,0.0002,0
4308,4308,,30,2,2,4,4,4,8,11,0.228993,0.242901,0,0.000384,0.000403,1
6407,6407,,30,3,3,6,4,4,8,11,0.229029,0.243132,0.000669,0.000384,0.000403,0.333333
6432,6432,,30,2,2,4,3,3,6,11,0.22272,0.234725,0,0.000299,0.000319,1
4054,4054,,30,3,3,6,5,5,10,11,0.241911,0.257157,0,0.000657,0.000656,1
4055,4055,,30,5,5,10,11,11,22,10,0.271649,0.291582,0.000025,0.002015,0.001993,0.7
6375,6375,,30,2,2,4,3,3,6,11,0.234844,0.248287,0.000002,0.000313,0.000313,0
6376,6376,,30,1,1,2,2,2,4,11,0.234749,0.247912,0,0.000294,0.000293,0
6377,6377,,30,1,1,2,2,2,4,11,0.234749,0.247912,0,0.000294,0.000293,0
6378,6378,,30,1,1,2,1,1,2,11,0.234749,0.247912,0,0.000294,0.000293,0
7505,7505,,30,1,1,2,2,2,4,11,0.234749,0.247912,0,0.000294,0.000293,0
7506,7506,,30,2,2,4,3,3,6,11,0.234844,0.248316,0,0.00045,0.000449,1
7527,7527,,30,1,1,2,1,1,2,11,0.234749,0.247912,0,0.000294,0.000293,0
7528,7528,,30,1,1,2,1,1,2,11,0.234749,0.247912,0,0.000294,0.000293,0
7862,7862,,30,1,1,2,2,2,4,11,0.234749,0.247912,0,0.000294,0.000293,0
7504,7504,,30,2,2,4,2,2,4,11,0.223375,0.236805,0,0.000354,0.00035,1
6963,6963,,30,1,1,2,1,1,2,11,0.222274,0.232672,0,0.000156,0.000156,0
3396,3396,,30,1,1,2,3,3,6,11,0.238572,0.251717,0,0.000331,0.000331,0
6396,6396,,30,2,2,4,2,2,4,11,0.238947,0.252485,0,0.000351,0.00035,1
6402,6402,,30,1,1,2,1,1,2,11,0.238572,0.251717,0,0.000331,0.000331,0
3397,3397,,30,1,1,2,6,6,12,11,0.223375,0.235821,0,0.000181,0.000179,0
3398,3398,,30,1,1,2,4,4,8,11,0.223375,0.235821,0,0.000181,0.000179,0
6404,6404,,30,1,1,2,2,2,4,11,0.223375,0.235821,0,0.000181,0.000179,0
6406,6406,,30,1,1,2,1,1,2,11,0.223375,0.235821,0,0.000181,0.000179,0
6408,6408,,30,1,1,2,1,1,2,11,0.223375,0.235821,0,0.000181,0.000179,0
6409,6409,,30,1,1,2,2,2,4,11,0.223375,0.235821,0,0.000181,0.000179,0
6752,6752,,30,1,1,2,1,1,2,11,0.223375,0.235821,0,0.000181,0.000179,0
6946,6946,,30,1,1,2,2,2,4,11,0.223375,0.235821,0,0.000181,0.000179,0
6410,6410,,30,1,1,2,1,1,2,11,0.22154,0.232178,0,0.00016,0.00016,0
6943,6943,,30,1,1,2,1,1,2,11,0.22154,0.232178,0,0.00016,0.00016,0
6412,6412,,30,2,2,4,2,2,4,10,0.26203,0.278848,0,0.001201,0.0012,1
6429,6429,,30,3,3,6,5,5,10,10,0.262078,0.279079,0,0.001325,0.001323,1
3415,3415,,2,2,2,4,3,3,6,11,0.24408,0.255852,0,0.000443,0.000464,1
3417,3417,,40,3,3,6,5,5,10,11,0.206571,0.21477,0,0.000013,0.000013,1
3832,3832,,40,22,21,43,30,31,61,10,0.260281,0.277736,0.016794,0.000769,0.000797,0.061594
6712,6712,,40,3,3,6,5,5,10,11,0.206571,0.21477,0,0.000013,0.000013,1
6839,6839,,40,3,4,7,4,5,9,11,0.206586,0.214943,0,0.000013,0.000013,0.666667
3420,3420,,40,4,4,8,6,6,12,11,0.206645,0.215145,0.001003,0.000013,0.000013,0.25
7105,7105,,40,1,1,2,1,1,2,12,0.171266,0.175884,0,0,0,0
7114,7114,,40,3,3,6,4,4,8,11,0.20663,0.214972,0.000502,0,0.000013,0.416667
7118,7118,,40,2,2,4,2,2,4,11,0.2066,0.214741,0,0.000013,0.000013,1
3423,3423,,40,1,1,2,1,1,2,12,0.184657,0.190214,0.000334,0,0.000001,0.5
5965,5965,,40,3,3,6,3,3,6,11,0.226442,0.236961,0.002005,0.000081,0.00011,0.083333
3426,3426,,40,2,2,4,2,2,4,11,0.226353,0.236585,0,0.000082,0.000111,1
7247,7247,,40,2,2,4,2,2,4,11,0.226353,0.236585,0,0.000082,0.000111,1
3429,3429,,40,1,1,2,1,1,2,11,0.226335,0.236412,0,0.00008,0.00011,0
3430,3430,,40,0,1,1,0,1,1,12,0.18504,0.191245,0,0,0.000001,0
3599,3599,,40,13,11,24,14,12,26,11,0.226976,0.239334,0.011997,0.000081,0.00011,0.026144
3442,3442,,2,2,2,4,2,2,4,11,0.250782,0.266225,0.000005,0.00076,0.000775,0
6505,6505,,2,25,25,50,25,25,50,11,0.228522,0.243305,0.000061,0.000824,0.000826,0
3445,3445,,2,1,1,2,1,1,2,11,0.222651,0.231885,0,0.000142,0.000163,0
3446,3446,,2,2,2,4,2,2,4,11,0.220693,0.230631,0,0.000132,0.000132,0
3743,3743,,2,4,4,8,4,4,8,11,0.248023,0.262788,0.000045,0.000705,0.000704,0
3517,3517,,2,4,4,8,5,5,10,10,0.250673,0.265044,0.000328,0.000933,0.000934,0.666667
3524,3524,,2,9,9,18,9,9,18,10,0.281698,0.301044,0.000001,0.006219,0.006211,0.722222
3582,3582,,2,16,16,32,17,17,34,10,0.29386,0.315033,0.000113,0.009668,0.00965,0.558333
3608,3608,,2,10,10,20,12,12,24,10,0.288225,0.308707,0,0.009776,0.009754,1
3611,3611,,2,14,14,28,14,14,28,10,0.289556,0.311629,0.000001,0.010385,0.01042,0.884615
3633,3633,,2,5,5,10,6,6,12,10,0.27423,0.29385,0,0.004081,0.004076,1
3701,3701,,2,1,1,2,1,1,2,10,0.250564,0.264409,0,0.000901,0.000903,0
3712,3712,,2,19,18,37,22,21,43,10,0.289614,0.312548,0.000006,0.013057,0.012599,0.795322
3820,3820,,2,15,15,30,20,20,40,10,0.290138,0.312871,0.000001,0.011901,0.012383,0.895833
3864,3864,,2,13,13,26,13,13,26,10,0.283553,0.30515,0.002005,0.007894,0.007928,0.538462
4026,4026,,2,1,1,2,1,1,2,10,0.250564,0.264409,0,0.000901,0.000903,0
4112,4112,,2,7,7,14,8,8,16,10,0.274282,0.294196,0,0.004941,0.004935,0.904762
4265,4265,,2,5,5,10,5,5,10,10,0.250695,0.265217,0.000342,0.000994,0.000996,0.4
4278,4278,,2,3,3,6,4,4,8,10,0.250651,0.264871,0,0.000932,0.000934,1
5749,5749,,2,2,2,4,2,2,4,10,0.250608,0.26464,0,0.000964,0.000966,0
5767,5767,,2,1,1,2,1,1,2,10,0.250564,0.264409,0,0.000901,0.000903,0
5770,5770,,2,1,1,2,1,1,2,10,0.250564,0.264409,0,0.000901,0.000903,0
6456,6456,,2,1,1,2,1,1,2,10,0.250564,0.264409,0,0.000901,0.000903,0
3467,3467,,2,9,9,18,13,13,26,10,0.266138,0.284392,0.000001,0.004446,0.00447,0.916667
3495,3495,,2,10,10,20,14,14,28,10,0.276543,0.295766,0.000002,0.005289,0.0053,0.911111
3566,3566,,2,34,34,68,36,36,72,10,0.299471,0.324194,0.00096,0.01354,0.013583,0.410873
3644,3644,,2,8,8,16,9,9,18,10,0.288081,0.30746,0,0.005407,0.0054,0.857143
3777,3777,,2,7,7,14,8,8,16,10,0.279624,0.296939,0.000056,0.0027,0.002724,0.380952
3807,3807,,2,15,15,30,18,18,36,10,0.291309,0.311449,0.000005,0.009067,0.009095,0.847619
3867,3867,,2,19,19,38,25,25,50,10,0.297618,0.319723,0.000008,0.012441,0.012505,0.839181
4019,4019,,2,26,26,52,28,28,56,10,0.296822,0.319909,0.001537,0.012137,0.012181,0.523077
4099,4099,,2,4,4,8,4,4,8,10,0.275855,0.292895,0.000034,0.002115,0.002139,0.5
3454,3454,,2,11,11,22,14,14,28,10,0.282997,0.304636,0,0.00837,0.008404,0.927273
3545,3545,,2,1,1,2,1,1,2,11,0.222651,0.231885,0,0.000142,0.000163,0
3705,3705,,2,3,5,8,7,9,16,11,0.244162,0.25643,0.000669,0.000443,0.000474,0.3
3457,3457,,2,5,5,10,5,5,10,10,0.273477,0.293778,0.000052,0.003752,0.003766,0.6
3461,3461,,2,2,2,4,2,2,4,11,0.238947,0.250686,0,0.000604,0.00057,1
3502,3502,,2,15,15,30,15,15,30,11,0.237648,0.252329,0.000008,0.002665,0.002676,0.257143
3591,3591,,2,2,2,4,2,2,4,11,0.238947,0.250686,0,0.000604,0.00057,1
3690,3690,,2,35,35,70,39,38,77,10,0.290225,0.315642,0.000066,0.016671,0.016377,0.598413
3863,3863,,2,11,10,21,12,11,23,10,0.276384,0.29751,0.000014,0.006371,0.005793,0.818182
5771,5771,,2,1,1,2,1,1,2,11,0.22807,0.238388,0,0.000261,0.00026,0
3459,3459,,2,3,4,7,3,4,7,10,0.262698,0.27846,0,0.002102,0.002601,0.916667
3460,3460,,40,5,5,10,5,5,10,11,0.226566,0.237498,0.004007,0.000082,0.000111,0.1
3794,3794,,40,2,2,4,2,2,4,11,0.22646,0.236834,0,0.000082,0.000111,1
6767,6767,,40,2,2,4,2,2,4,12,0.184751,0.190607,0.000334,0.000002,0.000001,0
7100,7100,,40,2,2,4,2,2,4,12,0.184775,0.190693,0.001337,0.000002,0.000001,0
7103,7103,,40,2,2,4,2,2,4,12,0.184751,0.190607,0.000334,0.000002,0.000001,0
3559,3559,,2,11,11,22,11,11,22,10,0.28648,0.306252,0.000025,0.006352,0.006369,0.8
3636,3636,,2,12,12,24,13,13,26,10,0.292283,0.312852,0.000001,0.009146,0.009173,0.939394
3641,3641,,2,13,14,27,14,16,30,10,0.283274,0.305075,0,0.009655,0.01005,0.934066
3660,3660,,2,10,10,20,10,10,20,10,0.275908,0.296413,0.000022,0.005232,0.005279,0.644444
3811,3811,,2,15,15,30,15,15,30,10,0.276569,0.298007,0.000015,0.007459,0.007509,0.780952
3855,3855,,2,10,10,20,11,11,22,10,0.284279,0.305543,0.000023,0.007165,0.00719,0.755556
4011,4011,,2,9,9,18,10,10,20,10,0.27641,0.296996,0,0.006419,0.006454,0.972222
4014,4014,,2,15,16,31,16,17,33,10,0.280113,0.303332,0.000018,0.008947,0.009309,0.775
4124,4124,,2,3,3,6,3,3,6,11,0.24633,0.259531,0.000672,0.000641,0.000639,0
7078,7078,,2,1,1,2,1,1,2,11,0.246204,0.258953,0,0.000629,0.000627,0
3463,3463,,2,3,4,7,3,4,7,10,0.260117,0.275284,0.000014,0.00093,0.001263,0.166667
3676,3676,,2,8,7,15,8,7,15,10,0.273089,0.292493,0.000139,0.00332,0.002971,0.357143
3696,3696,,2,1,1,2,1,1,2,11,0.238434,0.249456,0,0.000343,0.00031,0
4017,4017,,2,8,9,17,8,9,17,10,0.266728,0.284883,0.000106,0.002997,0.0033,0.416667
5741,5741,,2,1,1,2,1,1,2,11,0.238434,0.249456,0,0.000343,0.00031,0
4009,4009,,2,6,6,12,6,6,12,10,0.280931,0.299267,0.000147,0.003351,0.003383,0.4
4021,4021,,2,10,9,19,11,10,21,10,0.279868,0.298323,0.004051,0.003244,0.003276,0.177778
4063,4063,,2,2,2,4,2,2,4,10,0.275776,0.29249,0,0.001924,0.001947,1
4101,4101,,2,2,2,4,2,2,4,10,0.275776,0.29249,0,0.001924,0.001947,1
4216,4216,,2,4,4,8,4,4,8,10,0.278383,0.295096,0.000039,0.00256,0.002593,0.5
4292,4292,,2,5,5,10,5,5,10,10,0.27976,0.297138,0.000121,0.002671,0.002703,0.3
4348,4348,,2,5,5,10,5,5,10,10,0.277287,0.295109,0.000178,0.002068,0.00209,0.1
4356,4356,,2,6,5,11,6,5,11,10,0.279462,0.297746,0.000084,0.004829,0.003453,0.666667
6133,6133,,2,3,3,6,3,3,6,10,0.275829,0.292721,0.000033,0.001937,0.001961,0.333333
3685,3685,,2,15,15,30,16,16,32,10,0.28372,0.305814,0.000553,0.008252,0.008301,0.47619
3745,3745,,2,5,6,11,6,7,13,10,0.286879,0.305947,0,0.005212,0.00599,1
4018,4018,,2,1,1,2,1,1,2,10,0.241264,0.252423,0,0.000482,0.000481,0
4041,4041,,2,4,3,7,4,3,7,10,0.259836,0.274562,0.000014,0.001412,0.000937,0.166667
4359,4359,,2,6,6,12,6,6,12,10,0.264431,0.281949,0.000048,0.002172,0.002194,0.2
3491,3491,,2,2,2,4,2,2,4,12,0.198706,0.206,0,0.000022,0.000022,0
5761,5761,,2,3,3,6,3,3,6,11,0.247917,0.262413,0.000334,0.000692,0.000691,0.333333
7068,7068,,2,2,2,4,2,2,4,11,0.247896,0.262239,0.000334,0.00068,0.00068,0
3492,3492,,40,16,16,32,20,20,40,10,0.259696,0.275998,0.008414,0.000774,0.000805,0.033333
3808,3808,,40,10,11,21,16,17,33,10,0.257656,0.272411,0.006974,0.000694,0.000695,0.068182
3856,3856,,40,2,2,4,2,2,4,11,0.206349,0.214394,0,0.000024,0.000024,1
4147,4147,,40,2,2,4,2,2,4,11,0.206202,0.213903,0.000008,0.000013,0.000013,0
5960,5960,,40,1,1,2,2,2,4,11,0.206172,0.213672,0,0.000013,0.000012,0
5961,5961,,40,2,2,4,4,3,7,11,0.206187,0.213846,0,0.000013,0.000013,1
5963,5963,,40,2,2,4,3,4,7,11,0.206187,0.213846,0,0.000013,0.000013,1
6803,6803,,40,2,2,4,2,2,4,11,0.206202,0.213903,0.000002,0.000015,0.000014,0
7135,7135,,40,1,1,2,1,1,2,11,0.206172,0.213672,0,0.000013,0.000012,0
7136,7136,,40,1,1,2,1,1,2,11,0.206172,0.213672,0,0.000013,0.000012,0
7137,7137,,40,1,1,2,1,1,2,11,0.206172,0.213672,0,0.000013,0.000012,0
7138,7138,,40,1,1,2,1,1,2,11,0.206172,0.213672,0,0.000013,0.000012,0
7141,7141,,40,1,1,2,1,1,2,11,0.206172,0.213672,0,0.000013,0.000012,0
7142,7142,,40,1,1,2,2,2,4,11,0.206172,0.213672,0,0.000013,0.000012,0
7243,7243,,40,1,1,2,1,1,2,11,0.206172,0.213672,0,0.000013,0.000012,0
3497,3497,,2,2,2,4,2,2,4,11,0.247874,0.262182,0,0.000691,0.000691,1
5733,5733,,2,2,2,4,2,2,4,11,0.247874,0.262182,0,0.000691,0.000691,1
3498,3498,,2,2,2,4,2,2,4,11,0.250782,0.266225,0.000005,0.00076,0.000775,0
3652,3652,,2,4,4,8,4,4,8,11,0.251,0.267033,0.000002,0.001203,0.001217,0.833333
3829,3829,,2,4,4,8,4,4,8,11,0.250935,0.266831,0.000002,0.001312,0.001325,0.666667
3840,3840,,2,3,3,6,3,3,6,11,0.252207,0.269284,0.000003,0.00147,0.001485,0.333333
5737,5737,,2,2,2,4,2,2,4,11,0.200472,0.207717,0,0.000031,0.000031,1
3527,3527,,2,2,2,4,2,2,4,11,0.252163,0.269053,0,0.001427,0.001442,1
3531,3531,,40,5,9,14,8,12,20,11,0.226655,0.238347,0.004675,0.000081,0.00011,0.011111
7160,7160,,40,1,1,2,1,1,2,12,0.184787,0.190676,0,0.000002,0.000001,0
7162,7162,,40,1,1,2,1,1,2,12,0.184787,0.190676,0,0.000002,0.000001,0
7163,7163,,40,1,1,2,2,2,4,12,0.184787,0.190676,0,0.000002,0.000001,0
7164,7164,,40,1,1,2,2,2,4,13,0.155992,0.159583,0.000334,0.000002,0,0.5
7166,7166,,40,1,0,1,1,0,1,0,0,0,0,0.000002,0,0
7167,7167,,40,1,0,1,1,0,1,0,0,0,0,0.000002,0,0
7168,7168,,40,1,0,1,1,0,1,0,0,0,0,0.000002,0,0
7171,7171,,40,1,0,1,1,0,1,0,0,0,0,0.000002,0,0
3542,3542,,2,5,6,11,5,6,11,10,0.276172,0.29401,0,0.004292,0.004776,1
3589,3589,,2,8,8,16,10,10,20,10,0.272033,0.291087,0.000059,0.003914,0.003908,0.321429
3613,3613,,2,4,3,7,4,3,7,10,0.270124,0.288363,0.000001,0.002393,0.002064,0.666667
3630,3630,,2,2,2,4,2,2,4,11,0.245513,0.260236,0.000001,0.000667,0.000667,0
3661,3661,,2,2,2,4,2,2,4,11,0.253938,0.270129,0,0.001391,0.001388,1
3771,3771,,2,3,3,6,4,4,8,11,0.248045,0.264018,0.00001,0.000748,0.000746,0
3857,3857,,2,7,7,14,7,7,14,11,0.255874,0.273605,0,0.003327,0.00335,0.666667
3946,3946,,2,2,2,4,2,2,4,11,0.247938,0.263614,0.000006,0.000729,0.000727,0
4034,4034,,2,12,12,24,12,12,24,10,0.273451,0.293879,0.000169,0.004629,0.004651,0.469697
4285,4285,,2,2,2,4,2,2,4,11,0.253938,0.270129,0,0.001391,0.001388,1
4355,4355,,2,6,6,12,6,6,12,10,0.267892,0.28573,0.000045,0.00309,0.003094,0.4
5742,5742,,2,4,4,8,4,4,8,10,0.26361,0.279976,0.000022,0.001547,0.001554,0.166667
5747,5747,,2,1,1,2,1,1,2,11,0.244908,0.258995,0,0.000617,0.000617,0
3546,3546,,2,1,1,2,1,1,2,11,0.220929,0.230465,0,0.000127,0.000127,0
3826,3826,,2,3,3,6,3,3,6,10,0.269493,0.287062,0,0.002473,0.002497,1
3558,3558,,2,1,1,2,1,1,2,11,0.250738,0.265994,0,0.000747,0.000762,0
3560,3560,,2,4,4,8,4,4,8,10,0.250282,0.263888,0,0.001476,0.001484,0.666667
3561,3561,,2,3,3,6,3,3,6,10,0.268865,0.286582,0,0.001776,0.001773,0.666667
3873,3873,,2,17,17,34,17,17,34,10,0.274178,0.295749,0.000737,0.003154,0.003136,0.117647
3564,3564,,2,1,1,2,2,2,4,10,0.267296,0.284536,0,0.001399,0.001397,0
3580,3580,,2,5,5,10,5,5,10,10,0.271649,0.289903,0,0.003234,0.003255,1
3744,3744,,2,1,1,2,1,1,2,11,0.230474,0.240656,0,0.000218,0.000217,0
3806,3806,,2,6,6,12,6,6,12,10,0.269066,0.287194,0,0.00305,0.003077,0.933333
7669,7669,,2,5,5,10,5,5,10,10,0.271598,0.289788,0,0.003122,0.003148,1
3571,3571,,40,2,2,4,2,2,4,11,0.226798,0.237775,0,0.000015,0.000122,1
3726,3726,,2,4,3,7,4,3,7,11,0.24375,0.254949,0.001671,0.001064,0.000384,0
3578,3578,,2,4,4,8,4,4,8,10,0.26007,0.275255,0.000014,0.000981,0.000988,0.333333
3819,3819,,2,5,5,10,5,5,10,10,0.27265,0.292046,0.000048,0.003227,0.003241,0.4
4100,4100,,2,3,3,6,3,3,6,11,0.250804,0.266398,0.000005,0.000915,0.00093,0.333333
3598,3598,,2,2,2,4,2,2,4,11,0.252052,0.268254,0.000008,0.000858,0.000872,0
4385,4385,,40,1,1,2,1,1,2,14,0.135087,0.137621,0.000668,0.000002,0,0
5964,5964,,40,2,2,4,2,2,4,12,0.185012,0.191311,0,0.000002,0.000001,1
6716,6716,,40,1,1,2,1,1,2,12,0.185,0.191138,0,0.000002,0.000001,0
7087,7087,,40,1,2,3,1,2,3,12,0.185024,0.191369,0.000334,0.000002,0.000001,0
7093,7093,,40,1,1,2,1,1,2,13,0.156143,0.15986,0.000334,0.000002,0,0.5
7095,7095,,40,1,1,2,1,1,2,13,0.156169,0.159964,0.000668,0.000002,0,0.5
7098,7098,,40,2,2,4,2,2,4,12,0.185012,0.191311,0,0.000002,0.000001,1
7099,7099,,40,1,2,3,1,2,3,12,0.185024,0.191369,0,0.000002,0.000001,0.5
7201,7201,,40,1,1,2,1,1,2,13,0.156143,0.15986,0.000334,0.000002,0,0.5
7213,7213,,40,2,1,3,2,1,3,13,0.156143,0.15986,0.000334,0.000002,0,0.5
3604,3604,,2,1,1,2,1,1,2,12,0.179478,0.184109,0,0.000001,0.000001,0
5752,5752,,2,2,2,4,2,2,4,11,0.218719,0.227209,0.000669,0.000053,0.000052,0
3609,3609,,2,2,2,4,2,2,4,11,0.251197,0.26712,0.000003,0.000797,0.000813,0
3610,3610,,40,2,2,4,3,3,6,11,0.226371,0.236643,0.00005,0.000081,0.00011,0
3615,3615,,40,13,12,25,14,13,27,11,0.22703,0.23979,0.008011,0.000085,0.000113,0.07619
3693,3693,,40,12,12,24,14,14,28,11,0.227423,0.240807,0.007046,0.000095,0.000124,0.076923
6715,6715,,40,2,2,4,2,2,4,12,0.185047,0.191496,0,0.000002,0.000001,1
6723,6723,,40,2,1,3,2,1,3,12,0.185036,0.191323,0,0.000002,0.000001,0.5
6724,6724,,40,2,2,4,2,2,4,12,0.185047,0.191496,0,0.000002,0.000001,1
7088,7088,,40,5,4,9,6,5,11,11,0.226637,0.237654,0.001329,0.000082,0.000111,0.35
7184,7184,,40,2,3,5,2,3,5,12,0.185083,0.191785,0.000334,0.000002,0.000001,0.333333
7186,7186,,40,1,1,2,1,1,2,13,0.156186,0.160045,0.000334,0.000002,0,0.5
7188,7188,,40,2,2,4,2,2,4,12,0.185059,0.191554,0.000334,0.000002,0.000001,0
7190,7190,,40,3,2,5,3,2,5,12,0.185059,0.191554,0.000001,0.000002,0.000001,0.5
7193,7193,,40,2,3,5,2,3,5,12,0.185083,0.191785,0.000002,0.000002,0.000003,0.666667
7194,7194,,40,1,1,2,1,1,2,13,0.156177,0.160016,0.000334,0.000002,0,0.5
3616,3616,,39,1,1,2,1,1,2,1,1,1,0,0,0,0
7310,7310,,39,1,1,2,1,1,2,1,1,1,0,0,0,0
3729,3729,,2,6,6,12,6,6,12,10,0.277553,0.297463,0.000107,0.003665,0.003673,0.4
3881,3881,,2,2,2,4,2,2,4,11,0.213209,0.22487,0,0.000131,0.000129,0
4008,4008,,2,5,5,10,5,5,10,10,0.271828,0.290742,0.000124,0.002335,0.00234,0.1
4016,4016,,2,2,2,4,2,2,4,11,0.213209,0.22487,0,0.000131,0.000129,0
4028,4028,,2,4,4,8,4,4,8,11,0.252185,0.268832,0.000023,0.000891,0.000905,0
4038,4038,,2,2,2,4,2,2,4,10,0.267967,0.286037,0.000019,0.001418,0.001416,0
4040,4040,,2,2,2,4,2,2,4,11,0.213209,0.22487,0,0.000131,0.000129,0
4043,4043,,2,5,4,9,5,4,9,11,0.252185,0.268832,0.000037,0.001514,0.000905,0.1
4046,4046,,2,3,3,6,3,3,6,11,0.251306,0.267582,0.000011,0.000779,0.000795,0
4072,4072,,2,5,5,10,5,5,10,11,0.257863,0.276585,0.000031,0.001909,0.001921,0.2
4116,4116,,2,2,2,4,2,2,4,11,0.213209,0.22487,0,0.000131,0.000129,0
3620,3620,,40,2,3,5,3,3,6,11,0.226815,0.237948,0.000027,0.000093,0.000122,0.833333
3622,3622,,2,8,8,16,10,10,20,10,0.286822,0.306103,0,0.007392,0.007386,0.910714
3627,3627,,2,6,6,12,7,7,14,10,0.273347,0.293004,0,0.004738,0.00476,0.933333
3628,3628,,40,1,1,2,2,2,4,11,0.226335,0.236412,0,0.00008,0.00011,0
3653,3653,,2,2,2,4,2,2,4,10,0.260047,0.273831,0,0.001422,0.00144,1
4039,4039,,2,2,1,3,2,1,3,10,0.257449,0.270728,0,0.001422,0.000808,1
4047,4047,,2,4,4,8,4,4,8,10,0.266384,0.283112,0.000027,0.00228,0.002312,0.5
4128,4128,,2,1,1,2,1,1,2,10,0.257449,0.270728,0,0.000799,0.000808,0
3875,3875,,2,4,4,8,4,4,8,10,0.271394,0.28921,0,0.003033,0.003027,0.666667
4089,4089,,2,4,4,8,5,5,10,10,0.271394,0.28921,0,0.003033,0.003027,0.666667
3659,3659,,2,4,3,7,4,3,7,11,0.247896,0.262355,0,0.000713,0.000702,0.5
7064,7064,,2,2,2,4,2,2,4,11,0.247874,0.262182,0,0.000691,0.000691,1
7066,7066,,2,3,2,5,3,2,5,11,0.247874,0.262182,0,0.000702,0.000691,0.666667
3664,3664,,40,1,1,2,2,2,4,11,0.226335,0.236412,0,0.00008,0.00011,0
3665,3665,,2,1,1,2,1,1,2,11,0.233118,0.243989,0,0.00039,0.000398,0
4113,4113,,2,5,5,10,5,5,10,10,0.27247,0.291064,0.000002,0.003604,0.003628,0.7
3671,3671,,2,1,1,2,1,1,2,10,0.267296,0.284536,0,0.001399,0.001397,0
7056,7056,,2,6,6,12,6,6,12,11,0.224034,0.235657,0.000001,0.000396,0.000396,0.133333
4042,4042,,2,2,2,4,2,2,4,10,0.268465,0.283778,0,0.001723,0.001729,1
5726,5726,,2,2,2,4,2,2,4,10,0.268465,0.283778,0,0.001723,0.001729,1
5728,5728,,2,1,1,2,1,1,2,11,0.233118,0.243989,0,0.00039,0.000398,0
5744,5744,,2,1,1,2,1,1,2,11,0.233118,0.243989,0,0.00039,0.000398,0
5774,5774,,2,1,1,2,1,1,2,11,0.233118,0.243989,0,0.00039,0.000398,0
6825,6825,,2,1,1,2,1,1,2,11,0.233118,0.243989,0,0.00039,0.000398,0
3698,3698,,2,1,1,2,1,1,2,10,0.267296,0.284536,0,0.001399,0.001397,0
3862,3862,,2,6,6,12,7,7,14,10,0.286508,0.305294,0,0.005526,0.005522,0.9
3950,3950,,2,1,1,2,1,1,2,10,0.267296,0.284536,0,0.001399,0.001397,0
4037,4037,,2,3,3,6,4,4,8,10,0.271368,0.289037,0,0.002529,0.002523,1
6962,6962,,2,3,3,6,3,3,6,10,0.273063,0.292051,0,0.002853,0.002848,1
7827,7827,,2,1,1,2,1,1,2,10,0.267296,0.284536,0,0.001399,0.001397,0
3691,3691,,2,1,1,2,1,1,2,11,0.250738,0.265994,0,0.000747,0.000762,0
6719,6719,,40,2,2,4,2,2,4,12,0.185321,0.192085,0,0.000002,0.000002,0.833333
6721,6721,,40,3,2,5,3,3,6,12,0.185321,0.192085,0.000334,0.000002,0.000002,0.416667
6725,6725,,40,1,3,4,2,3,5,12,0.185333,0.192258,0,0.000002,0.000002,0.833333
7117,7117,,40,2,1,3,2,1,3,13,0.156363,0.160345,0.000334,0.000002,0,0.666667
7177,7177,,40,2,2,4,2,2,4,12,0.185321,0.192085,0,0.000002,0.000002,0.5
7178,7178,,40,1,1,2,1,1,2,12,0.185297,0.191854,0,0.000002,0.000002,0
7179,7179,,40,2,2,4,2,2,4,12,0.185309,0.192027,0,0.000002,0.000002,1
7181,7181,,40,2,2,4,2,2,4,12,0.185309,0.192027,0,0.000002,0.000002,1
7182,7182,,40,1,1,2,1,1,2,12,0.185297,0.191854,0,0.000002,0.000002,0
4007,4007,,2,3,3,6,3,3,6,11,0.253225,0.26917,0.000002,0.001152,0.001148,0.333333
3796,3796,,2,2,1,3,2,1,3,11,0.244018,0.255563,0,0.000308,0.000301,1
3851,3851,,2,2,1,3,3,2,5,11,0.244018,0.255563,0,0.000308,0.000301,1
5989,5989,,2,1,1,2,1,1,2,12,0.19626,0.202402,0,0.000008,0.000007,0
3711,3711,,2,2,3,5,3,4,7,10,0.284279,0.302056,0,0.002563,0.003344,1
6883,6883,,2,1,1,2,1,1,2,11,0.243668,0.254487,0,0.000384,0.000384,0
7086,7086,,2,1,1,2,1,1,2,11,0.243668,0.254487,0,0.000384,0.000384,0
3724,3724,,2,1,1,2,1,1,2,11,0.220929,0.230465,0,0.000127,0.000127,0
5731,5731,,2,1,1,2,1,1,2,12,0.195993,0.201688,0,0.000006,0.000017,0
7082,7082,,2,2,1,3,2,1,3,12,0.195993,0.201688,0.000334,0.000006,0.000017,0
7121,7121,,2,1,1,2,1,1,2,11,0.220608,0.230255,0,0.000121,0.00012,0
6132,6132,,2,2,2,4,2,2,4,11,0.250847,0.266369,0.000006,0.000758,0.000773,0
3804,3804,,2,1,1,2,1,1,2,11,0.247853,0.262008,0,0.00068,0.00068,0
4084,4084,,2,1,1,2,1,1,2,11,0.247853,0.262008,0,0.00068,0.00068,0
4296,4296,,2,2,3,5,2,3,5,11,0.247917,0.262413,0.000669,0.00068,0.000691,0.333333
4338,4338,,2,1,1,2,1,1,2,11,0.247853,0.262008,0,0.00068,0.00068,0
4341,4341,,2,1,1,2,1,1,2,11,0.247853,0.262008,0,0.00068,0.00068,0
5723,5723,,2,1,1,2,1,1,2,11,0.247853,0.262008,0,0.00068,0.00068,0
5740,5740,,2,3,3,6,3,3,6,11,0.252207,0.269284,0.00001,0.00144,0.001455,0.333333
5746,5746,,2,2,2,4,2,2,4,11,0.247896,0.262239,0.000669,0.00068,0.00068,0
5748,5748,,2,1,1,2,1,1,2,11,0.247853,0.262008,0,0.00068,0.00068,0
5769,5769,,2,1,1,2,1,1,2,11,0.247853,0.262008,0,0.00068,0.00068,0
6129,6129,,2,1,1,2,1,1,2,11,0.247853,0.262008,0,0.00068,0.00068,0
6881,6881,,2,1,1,2,1,1,2,11,0.247853,0.262008,0,0.00068,0.00068,0
7014,7014,,2,1,1,2,1,1,2,11,0.247853,0.262008,0,0.00068,0.00068,0
7067,7067,,2,2,3,5,2,3,5,11,0.247917,0.262413,0,0.000691,0.000702,0.666667
7073,7073,,2,1,1,2,1,1,2,11,0.247853,0.262008,0,0.00068,0.00068,0
7074,7074,,2,2,2,4,2,2,4,11,0.247896,0.262239,0.000669,0.00068,0.00068,0
7076,7076,,2,1,1,2,1,1,2,11,0.247853,0.262008,0,0.00068,0.00068,0
3764,3764,,40,4,5,9,6,7,13,11,0.20666,0.215318,0.001503,0.000013,0.000013,0.3
6717,6717,,40,2,1,3,3,2,5,14,0.127626,0.129782,0.000167,0,0,0
6722,6722,,40,4,3,7,4,4,8,11,0.206615,0.214914,0,0.000013,0.000013,0.833333
7108,7108,,40,5,5,10,5,6,11,11,0.206645,0.215261,0.000502,0.000013,0.000013,0.5
7208,7208,,40,2,3,5,3,3,6,12,0.171327,0.176462,0.000836,0,0,0.333333
3854,3854,,40,3,3,6,3,3,6,11,0.226388,0.236816,0.000334,0.000082,0.000111,0.666667
3865,3865,,40,1,1,2,2,2,4,11,0.226335,0.236412,0,0.00008,0.00011,0
5959,5959,,40,1,1,2,1,1,2,11,0.226335,0.236412,0,0.00008,0.00011,0
5967,5967,,40,1,1,2,2,2,4,11,0.226335,0.236412,0,0.00008,0.00011,0
6718,6718,,40,1,1,2,1,1,2,11,0.226335,0.236412,0,0.00008,0.00011,0
6742,6742,,40,3,3,6,3,3,6,11,0.226388,0.236816,0.000334,0.000082,0.000111,0.666667
3805,3805,,2,1,1,2,1,1,2,11,0.250738,0.265994,0,0.000747,0.000762,0
5969,5969,,40,2,2,4,2,2,4,11,0.204913,0.212071,0.000001,0.000011,0.000011,0
7144,7144,,40,3,3,6,5,5,10,11,0.204928,0.212244,0.000669,0.000011,0.000011,0.5
7145,7145,,40,3,2,5,4,3,7,11,0.204899,0.212013,0,0.000012,0.000011,0.833333
7146,7146,,40,1,1,2,3,3,6,11,0.204884,0.21184,0,0.000011,0.000011,0
7147,7147,,40,2,3,5,3,4,7,11,0.204928,0.212244,0,0.000011,0.000011,0.833333
7148,7148,,40,1,1,2,1,1,2,11,0.204884,0.21184,0,0.000011,0.000011,0
7150,7150,,40,1,1,2,1,1,2,12,0.170075,0.174114,0.000334,0.000011,0,0.5
7237,7237,,40,1,1,2,1,1,2,1,1,1,0.000334,0.000011,0,0
7106,7106,,40,1,1,2,1,1,2,11,0.206541,0.214423,0,0.000013,0.000012,0
7107,7107,,40,3,3,6,4,3,7,11,0.206571,0.21477,0,0.000013,0.000013,0.666667
7112,7112,,40,1,1,2,1,1,2,11,0.206541,0.214423,0,0.000013,0.000012,0
7113,7113,,40,4,3,7,5,4,9,11,0.206571,0.21477,0,0.000013,0.000013,0.75
7115,7115,,40,2,2,4,2,2,4,11,0.2066,0.214741,0.000501,0.000013,0.000012,0.5
7116,7116,,40,1,1,2,1,1,2,12,0.171215,0.175694,0.000334,0.000013,0,0.5
7242,7242,,40,1,1,2,1,1,2,11,0.206541,0.214423,0,0.000013,0.000012,0
7246,7246,,40,1,1,2,1,1,2,12,0.171215,0.175694,0.000334,0.000013,0,0.5
3838,3838,,2,1,1,2,1,1,2,11,0.220929,0.230465,0,0.000127,0.000127,0
3845,3845,,2,1,1,2,1,1,2,11,0.212362,0.223564,0,0.000112,0.00011,0
3846,3846,,2,1,2,3,1,2,3,10,0.261176,0.275944,0,0.00005,0.000872,0
5751,5751,,2,1,1,2,1,1,2,11,0.238394,0.25058,0,0.000468,0.000495,0
6739,6739,,2,1,1,2,1,1,2,11,0.238394,0.25058,0,0.000468,0.000495,0
3860,3860,,40,2,2,4,2,2,4,12,0.184621,0.190254,0,0.000004,0.000003,1
4083,4083,,2,3,3,6,3,3,6,10,0.258278,0.273887,0.00001,0.001383,0.001407,0.333333
4287,4287,,2,1,1,2,1,1,2,10,0.249805,0.2623,0,0.000623,0.000632,0
3872,3872,,2,1,1,2,1,1,2,11,0.250738,0.265994,0,0.000747,0.000762,0
3880,3880,,2,2,2,4,2,2,4,11,0.250782,0.266225,0.000005,0.00076,0.000775,0
3948,3948,,2,1,1,2,1,1,2,11,0.250738,0.265994,0,0.000747,0.000762,0
4020,4020,,2,2,2,4,2,2,4,11,0.250782,0.266225,0.000005,0.00076,0.000775,0
4087,4087,,2,2,2,4,2,2,4,11,0.250782,0.266225,0.000005,0.00076,0.000775,0
4103,4103,,2,1,1,2,1,1,2,11,0.250738,0.265994,0,0.000747,0.000762,0
4127,4127,,2,1,1,2,1,1,2,11,0.250738,0.265994,0,0.000747,0.000762,0
4257,4257,,2,2,2,4,2,2,4,11,0.250782,0.266225,0.000005,0.00076,0.000775,0
4263,4263,,2,1,1,2,1,1,2,11,0.250738,0.265994,0,0.000747,0.000762,0
5772,5772,,2,1,1,2,1,1,2,11,0.250738,0.265994,0,0.000747,0.000762,0
7122,7122,,2,1,1,2,1,1,2,11,0.250738,0.265994,0,0.000747,0.000762,0
3938,3938,,30,1,1,2,1,1,2,10,0.269493,0.286818,0,0.001321,0.001297,0
6231,6231,,30,2,2,4,2,2,4,11,0.212362,0.2219,0,0.000044,0.000044,1
3913,3913,,30,3,2,5,3,2,5,12,0.189681,0.196446,0,0.000011,0.000007,0
3916,3916,,30,3,3,6,4,4,8,11,0.234025,0.246668,0.000334,0.000278,0.00028,0.333333
6204,6204,,30,2,2,4,2,2,4,11,0.23376,0.245911,0.000237,0.000186,0.000187,0
3920,3920,,30,3,3,6,4,4,8,11,0.212393,0.222131,0.000836,0.000036,0.000037,0.166667
6209,6209,,30,3,2,5,3,2,5,12,0.175217,0.180813,0.000334,0.000037,0.000001,0.5
6233,6233,,30,1,1,2,1,1,2,12,0.175196,0.180582,0,0.000001,0.000001,0
3921,3921,,30,1,2,3,1,2,3,11,0.212362,0.2219,0.000167,0,0.000037,0.5
3924,3924,,30,1,1,2,1,1,2,11,0.233722,0.24568,0,0.000186,0.000187,0
3927,3927,,30,1,2,3,1,2,3,11,0.23376,0.245911,0.000098,0.000186,0.000187,0
4086,4086,,30,1,1,2,1,1,2,11,0.223478,0.233635,0,0.00008,0.000079,0
4191,4191,,5,1,1,2,1,1,2,10,0.254497,0.268973,0,0.001446,0.001444,0
4192,4192,,5,1,1,2,1,1,2,10,0.254497,0.268973,0,0.001446,0.001444,0
4193,4193,,5,1,1,2,1,1,2,10,0.254497,0.268973,0,0.001446,0.001444,0
4194,4194,,5,1,1,2,1,1,2,10,0.254497,0.268973,0,0.001446,0.001444,0
4195,4195,,5,1,1,2,1,1,2,10,0.254497,0.268973,0,0.001446,0.001444,0
5787,5787,,5,1,1,2,1,1,2,10,0.254497,0.268973,0,0.001446,0.001444,0
3966,3966,,30,1,1,2,1,1,2,11,0.221217,0.230683,0,0.000076,0.000077,0
3968,3968,,30,1,1,2,1,1,2,11,0.221217,0.230683,0,0.000076,0.000077,0
3972,3972,,7,1,1,2,1,1,2,11,0.205805,0.214567,0,0.000046,0.000045,0
3984,3984,,30,1,1,2,2,1,3,11,0.220238,0.229523,0,0.000088,0.000089,0
3978,3978,,30,1,1,2,1,1,2,11,0.22762,0.239314,0,0.000259,0.000228,0
3979,3979,,30,1,1,2,1,2,3,11,0.22762,0.239314,0,0.000259,0.000228,0
3996,3996,,1,3,3,6,3,3,6,12,0.173688,0.179089,0,0.000001,0.000001,1
5441,5441,,1,3,3,6,3,3,6,12,0.173688,0.179089,0,0.000001,0.000001,1
5448,5448,,1,3,3,6,3,3,6,12,0.173698,0.179147,0.000669,0.000001,0.000001,0.333333
5449,5449,,1,3,3,6,3,3,6,12,0.173698,0.179147,0,0.000001,0.000001,0.666667
6236,6236,,30,1,1,2,1,1,2,11,0.215454,0.226128,0,0.000049,0.000049,0
6270,6270,,30,2,3,5,3,4,7,11,0.224103,0.236167,0.000003,0.00005,0.000117,0.666667
6296,6296,,49,3,3,6,3,3,6,11,0.215518,0.22659,0.001337,0.000049,0.000049,0
6297,6297,,30,1,1,2,1,1,2,11,0.215454,0.226128,0,0.000049,0.000049,0
6316,6316,,30,2,2,4,2,2,4,11,0.21547,0.226301,0,0.000051,0.00005,1
4223,4223,,2,1,1,2,1,1,2,11,0.228902,0.238591,0,0.000195,0.000195,0
6135,6135,,2,1,1,2,1,1,2,11,0.228902,0.238591,0,0.000195,0.000195,0
7065,7065,,2,2,2,4,2,2,4,11,0.218703,0.227151,0,0.000053,0.000053,1
7070,7070,,2,2,2,4,2,2,4,11,0.218703,0.227151,0,0.000053,0.000053,1
7071,7071,,2,2,2,4,2,2,4,11,0.218719,0.227209,0.000334,0.000053,0.000052,0.5
6098,6098,,7,1,1,2,1,1,2,10,0.259206,0.275989,0,0.001183,0.001181,0
6119,6119,,7,1,1,2,2,2,4,10,0.259206,0.275989,0,0.001183,0.001181,0
6122,6122,,7,1,1,2,1,1,2,10,0.259206,0.275989,0,0.001183,0.001181,0
6125,6125,,7,1,1,2,1,1,2,10,0.259206,0.275989,0,0.001183,0.001181,0
6137,6137,,7,5,5,10,5,5,10,10,0.259602,0.277161,0.000669,0.001367,0.001366,0.5
6146,6146,,7,1,1,2,1,1,2,10,0.259206,0.275989,0,0.001183,0.001181,0
6156,6156,,7,2,2,4,2,2,4,10,0.259369,0.276364,0,0.001241,0.001239,1
6161,6161,,7,1,1,2,1,1,2,10,0.259206,0.275989,0,0.001183,0.001181,0
6162,6162,,7,1,1,2,1,1,2,10,0.259206,0.275989,0,0.001183,0.001181,0
6163,6163,,7,1,1,2,1,1,2,10,0.259206,0.275989,0,0.001183,0.001181,0
6164,6164,,7,1,1,2,1,1,2,10,0.259206,0.275989,0,0.001183,0.001181,0
6466,6466,,7,1,1,2,1,1,2,10,0.259206,0.275989,0,0.001183,0.001181,0
7563,7563,,7,2,2,4,4,4,8,10,0.259602,0.276659,0,0.001254,0.001254,1
5688,5688,,5,3,3,6,5,4,9,11,0.195475,0.203228,0.000669,0.000474,0.000017,0.416667
5693,5693,,5,1,1,2,1,1,2,10,0.242684,0.256663,0,0.000465,0.000465,0
4060,4060,,25,0,1,1,0,1,1,12,0.156633,0.159943,0,0,0,0
5404,5404,,0,2,1,3,2,1,3,12,0.197834,0.206284,0.000334,0.000006,0.000006,0.5
5405,5405,,0,1,1,2,1,1,2,12,0.197834,0.206284,0,0.000006,0.000006,0
5407,5407,,0,1,1,2,1,1,2,12,0.197834,0.206284,0,0.000006,0.000006,0
5409,5409,,0,3,3,6,3,3,6,12,0.197861,0.20663,0,0.000006,0.000006,0.666667
5410,5410,,0,1,1,2,1,1,2,12,0.197834,0.206284,0,0.000006,0.000006,0
5411,5411,,0,3,3,6,3,3,6,12,0.197875,0.206688,0,0.000006,0.000006,0.833333
5412,5412,,0,5,4,9,5,4,9,12,0.197888,0.206861,0.001003,0.000006,0.000006,0.35
5414,5414,,0,2,2,4,2,2,4,12,0.197847,0.206457,0,0.000006,0.000006,1
5415,5415,,0,1,1,2,1,1,2,12,0.197834,0.206284,0,0.000006,0.000006,0
5416,5416,,0,2,1,3,2,1,3,12,0.197834,0.206284,0,0.000006,0.000006,1
5417,5417,,0,1,1,2,1,1,2,12,0.197834,0.206284,0,0.000006,0.000006,0
5418,5418,,0,1,3,4,1,3,4,12,0.197861,0.20663,0,0.000006,0.000006,0.666667
6064,6064,,0,2,1,3,2,1,3,12,0.197834,0.206284,0,0.000006,0.000006,1
6758,6758,,0,2,3,5,2,3,5,12,0.197875,0.206688,0,0.000006,0.000006,1
6919,6919,,0,2,2,4,2,2,4,12,0.197847,0.206457,0,0.000006,0.000006,1
7615,7615,,0,1,1,2,1,1,2,13,0.165179,0.170002,0,0.000006,0,1
7616,7616,,0,2,2,4,2,2,4,12,0.197847,0.206457,0,0.000006,0.000006,1
7617,7617,,0,2,1,3,2,1,3,13,0.165207,0.170146,0,0.000006,0,1
7618,7618,,0,2,2,4,2,2,4,12,0.197847,0.206457,0,0.000006,0.000006,1
7620,7620,,0,1,1,2,1,1,2,12,0.197834,0.206284,0,0.000006,0.000006,0
5889,5889,,28,1,2,3,1,2,3,12,0.182855,0.188086,0.000111,0.000046,0.000001,0.5
7946,7946,,28,1,1,2,1,1,2,12,0.182797,0.187682,0.000334,0.000046,0,0.5
7534,7534,,34,2,2,4,3,3,6,12,0.175537,0.181515,0,0.000002,0.000002,0.5
7932,7932,,30,1,1,2,1,1,2,12,0.19529,0.203521,0,0.000019,0.000019,0
4106,4106,,41,1,1,2,1,1,2,1,1,1,0,0,0,0
4107,4107,,41,1,1,2,1,1,2,1,1,1,0,0,0,0
4219,4219,,2,1,1,2,1,1,2,12,0.197658,0.20417,0,0.00001,0.00001,0
5758,5758,,2,1,1,2,1,1,2,11,0.212362,0.223564,0,0.000112,0.00011,0
5914,5914,,47,1,1,2,1,1,2,12,0.169386,0.174449,0,0,0,0
5917,5917,,47,1,1,2,1,1,2,13,0.144872,0.148119,0.000334,0,0,0.5
7642,7642,,1,1,1,2,1,1,2,12,0.164136,0.168417,0,0,0,0
7029,7029,,2,1,1,2,2,2,4,12,0.182105,0.187261,0,0.000002,0.000002,0
5755,5755,,2,1,1,2,1,1,2,12,0.198678,0.205769,0,0.000011,0.000011,0
4326,4326,,9,3,3,6,3,3,6,12,0.169815,0.175815,0,0.000002,0.000002,1
5573,5573,,42,2,2,4,2,2,4,12,0.172504,0.178356,0.000669,0.000002,0.000002,0
4353,4353,,7,0,1,1,0,1,1,10,0.262669,0.279103,0,0,0.001591,0
6110,6110,,7,1,1,2,1,1,2,11,0.210888,0.220205,0,0.000067,0.000067,0
6113,6113,,7,1,1,2,1,1,2,11,0.210888,0.220205,0,0.000067,0.000067,0
7480,7480,,7,1,1,2,1,1,2,11,0.210888,0.220205,0,0.000067,0.000067,0
4365,4365,,7,1,1,2,1,1,2,11,0.206113,0.214448,0,0.000022,0.000022,0
6112,6112,,7,1,1,2,1,1,2,11,0.208345,0.216648,0,0.000027,0.000027,0
7094,7094,,40,1,1,2,1,1,2,13,0.15616,0.159906,0.000668,0,0,0
5406,5406,,0,1,1,2,1,1,2,13,0.165207,0.170146,0,0,0,0
5982,5982,,0,1,1,2,1,1,2,12,0.181853,0.188007,0,0.000001,0.000001,0
5980,5980,,0,1,1,2,1,1,2,12,0.181841,0.187949,0,0.000001,0.000001,0
5444,5444,,1,1,1,2,1,1,2,13,0.148008,0.151266,0,0,0,0
5446,5446,,1,1,1,2,1,1,2,13,0.148,0.151272,0,0,0,0
5455,5455,,2,1,1,2,1,1,2,12,0.182105,0.187261,0,0.000002,0.000002,0
5457,5457,,2,1,1,2,1,1,2,11,0.255172,0.268079,0,0.000009,0.000557,1
5492,5492,,3,3,3,6,5,5,10,13,0.153103,0.156925,0,0,0,0.333333
5466,5466,,4,3,3,6,3,3,6,13,0.152247,0.156297,0,0,0.000001,0.166667
5467,5467,,4,2,2,4,2,2,4,12,0.185559,0.191786,0,0,0.000002,0.666667
5471,5471,,4,2,2,4,2,2,4,12,0.185559,0.191786,0.000138,0.000002,0.000002,0.5
5544,5544,,4,3,3,6,3,3,6,13,0.152215,0.156164,0,0,0,0
5472,5472,,3,3,4,7,3,4,7,11,0.202768,0.210699,0.000338,0.000013,0.000026,0.25
5473,5473,,3,2,2,4,2,2,4,12,0.168683,0.173372,0.000319,0,0,0
5474,5474,,3,2,2,4,2,2,4,13,0.144517,0.147882,0.000001,0,0,0
6789,6789,,3,3,3,6,3,3,6,12,0.1689,0.174111,0.000352,0,0,0
5499,5499,,3,2,2,4,2,2,4,12,0.16891,0.173678,0.000201,0,0,0
5508,5508,,3,2,3,5,2,3,5,11,0.203096,0.210956,0,0,0.000013,0.666667
5482,5482,,4,2,2,4,2,2,4,16,0.109116,0.110952,0.000669,0,0,0
5522,5522,,4,1,1,2,1,1,2,17,0.098384,0.099689,0,0,0,0
5543,5543,,4,2,2,4,2,2,4,15,0.122465,0.124804,0.001337,0,0,0
5510,5510,,4,2,2,4,2,2,4,12,0.179277,0.184425,0,0.000001,0.000001,0
5502,5502,,3,2,2,4,3,3,6,13,0.153095,0.156752,0,0,0,1
5515,5515,,3,3,3,6,3,3,6,11,0.202854,0.210517,0.000003,0.000013,0.000013,0.333333
5529,5529,,3,2,2,4,2,2,4,11,0.202512,0.20981,0,0.000013,0.000013,1
7253,7253,,3,2,2,4,2,2,4,13,0.145047,0.148748,0.000002,0,0,0
5501,5501,,3,2,2,4,2,2,4,11,0.202484,0.209781,0.000001,0.000013,0.000013,0
5504,5504,,3,2,2,4,2,2,4,13,0.145018,0.148615,0.000001,0,0,0
5506,5506,,3,2,2,4,2,2,4,12,0.168999,0.173903,0.000307,0,0,0
5539,5539,,3,2,2,4,2,2,4,12,0.168575,0.173185,0.000001,0,0,0
5532,5532,,4,3,2,5,3,2,5,13,0.157095,0.1614,0,0.000002,0,1
7498,7498,,42,1,1,2,1,1,2,13,0.147132,0.150739,0,0,0,0
5596,5596,,14,1,1,2,1,1,2,11,0.203857,0.211718,0,0.000026,0.000026,0
5604,5604,,15,0,1,1,0,1,1,11,0.203668,0.211297,0,0,0.000012,0
5616,5616,,43,1,1,2,1,1,2,13,0.158798,0.162403,0.00167,0,0,0
5621,5621,,43,1,1,2,1,1,2,12,0.188689,0.194495,0.00167,0,0,0
5618,5618,,43,1,1,2,1,1,2,14,0.137083,0.139569,0.00167,0,0,0
7430,7430,,43,1,1,2,1,1,2,11,0.232442,0.243257,0.001671,0,0.000121,0
5642,5642,,51,1,1,2,1,1,2,3,0.5,0.611111,0,0,0,0
5645,5645,,51,2,2,4,2,2,4,2,0.75,0.833333,0,0,0,0
7634,7634,,51,2,2,4,2,2,4,2,0.75,0.833333,0,0,0,0
5680,5680,,19,1,1,2,1,1,2,11,0.19504,0.202229,0,0.000008,0.000008,0
5682,5682,,19,1,1,2,1,1,2,11,0.19504,0.202229,0,0.000008,0.000008,0
5686,5686,,5,1,1,2,1,2,3,12,0.163522,0.167983,0,0,0.000008,0
5734,5734,,44,0,1,1,0,1,1,1,1,1,0,0,0,0
4058,4058,,44,1,0,1,1,0,1,0,0,0,0,0,0,0
5739,5739,,2,1,2,3,1,2,3,11,0.218719,0.227209,0,0.000001,0.000053,1
5745,5745,,45,1,1,2,2,2,4,1,1,1,0,0,0,0
7063,7063,,45,1,1,2,2,2,4,1,1,1,0,0,0,0
5777,5777,,2,1,1,2,1,1,2,12,0.198665,0.205711,0,0.000011,0.000011,0
5809,5809,,2,1,0,1,1,0,1,0,0,0,0,0.000003,0,0
5840,5840,,27,0,1,1,0,1,1,14,0.136044,0.139024,0,0,0,0
5842,5842,,27,1,1,2,1,1,2,12,0.186591,0.192901,0,0.000003,0.000003,0
5893,5893,,46,3,3,6,3,3,6,13,0.164473,0.169047,0,0,0,0.666667
5894,5894,,46,4,4,8,4,4,8,12,0.196809,0.204335,0.001002,0.000003,0.000003,0.5
5895,5895,,46,2,2,4,2,2,4,13,0.164463,0.168873,0,0,0,1
5906,5906,,46,3,3,6,3,3,6,12,0.196795,0.204162,0.000334,0.000003,0.000003,0.666667
5910,5910,,30,2,2,4,2,2,4,12,0.169386,0.174634,0,0,0.000001,0
5898,5898,,46,3,5,8,3,5,8,12,0.196822,0.204508,0.000335,0.000004,0.000004,0.25
5899,5899,,46,2,2,4,2,2,4,11,0.203943,0.213016,0.000008,0.000003,0.000022,0.666667
5903,5903,,46,1,1,2,1,1,2,12,0.196755,0.203757,0,0,0.000003,1
6771,6771,,46,2,2,4,2,2,4,12,0.196782,0.203988,0,0.000003,0.000003,1
5912,5912,,30,1,1,2,1,1,2,11,0.203828,0.212525,0,0,0.000018,1
5915,5915,,47,1,1,2,1,1,2,12,0.169396,0.174507,0.000334,0,0,0.5
5941,5941,,30,1,1,2,1,1,2,10,0.24248,0.254778,0,0.00002,0.000339,1
7214,7214,,40,1,1,2,1,1,2,12,0.184645,0.190156,0,0.000002,0.000001,0
7215,7215,,40,1,1,2,1,1,2,13,0.15589,0.159306,0.000334,0.000002,0,0.5
3027,3027,,30,1,0,1,1,0,1,0,0,0,0,0.000008,0,0
7562,7562,,30,1,1,2,1,1,2,10,0.244369,0.256781,0,0.000008,0.000488,1
6240,6240,,48,2,2,4,2,2,4,14,0.141609,0.144835,0.000006,0,0,0
6243,6243,,48,2,2,4,2,2,4,13,0.164867,0.169461,0.000672,0,0,0
6333,6333,,48,2,2,4,2,2,4,14,0.141228,0.144266,0.000002,0,0,0
6245,6245,,38,2,2,4,2,2,4,13,0.164801,0.16934,0,0,0,1
6304,6304,,38,3,3,6,3,3,6,12,0.180861,0.187048,0.000059,0.000001,0.000001,0.333333
6258,6258,,48,2,2,4,2,2,4,13,0.164248,0.168376,0.000669,0,0,0
6325,6325,,48,2,2,4,2,2,4,12,0.196487,0.203209,0.001337,0.000003,0.000003,0
6329,6329,,48,1,1,2,1,1,2,14,0.141083,0.143711,0,0,0,0
6265,6265,,49,1,1,2,1,1,2,12,0.177316,0.183307,0,0.000001,0.000001,0
7577,7577,,30,1,1,2,1,1,2,11,0.234196,0.245736,0,0.000003,0.000162,1
6295,6295,,49,1,1,2,1,1,2,12,0.177316,0.183307,0,0.000001,0.000001,0
7457,7457,,30,1,1,2,1,1,2,11,0.206882,0.216993,0,0.000052,0.000051,0
6363,6363,,30,1,1,2,1,1,2,11,0.21547,0.225459,0,0.000065,0.000064,0
7894,7894,,30,1,1,2,1,1,2,11,0.21547,0.225459,0,0.000065,0.000064,0
6405,6405,,30,1,1,2,1,1,2,12,0.186362,0.193588,0,0.000006,0.000006,0
6448,6448,,50,1,1,2,1,1,2,1,1,1,0,0,0,0
6449,6449,,50,1,1,2,1,1,2,1,1,1,0,0,0,0
7111,7111,,40,2,2,4,3,3,6,13,0.14629,0.149586,0.000334,0,0,0
3413,3413,,40,1,0,1,1,0,1,0,0,0,0,0,0,0
6729,6729,,40,1,2,3,2,2,4,12,0.171276,0.176057,0,0,0,0.5
6740,6740,,2,0,1,1,0,1,1,11,0.196877,0.203876,0,0,0.000007,0
6764,6764,,40,2,2,4,2,2,4,13,0.155983,0.159707,0.000669,0,0,0
7101,7101,,40,1,1,2,1,1,2,14,0.134942,0.137342,0,0,0,0
7104,7104,,40,2,2,4,2,2,4,13,0.155966,0.159661,0,0,0,0
6779,6779,,51,1,1,2,1,1,2,3,0.5,0.611111,0,0,0,0
6792,6792,,30,1,1,2,1,1,2,11,0.200431,0.207122,0,0.000005,0.000005,0
6960,6960,,40,1,1,2,1,1,2,12,0.185012,0.191196,0.000334,0,0.000001,0.5
6979,6979,,0,1,1,2,1,1,2,11,0.222248,0.233531,0.000335,0,0.000067,0
6981,6981,,0,0,1,1,0,1,1,12,0.181887,0.188021,0,0,0,0
7001,7001,,2,0,1,1,0,1,1,11,0.247896,0.262091,0,0,0.00068,0
7054,7054,,2,0,1,1,0,1,1,11,0.227645,0.237742,0,0,0.000239,0
7075,7075,,2,1,1,2,1,1,2,12,0.198665,0.205711,0,0.000011,0.000011,0
7083,7083,,2,0,1,1,0,1,1,13,0.163922,0.167387,0,0,0,0
7207,7207,,40,1,0,1,1,0,1,0,0,0,0,0,0,0
7191,7191,,40,2,2,4,2,2,4,12,0.184799,0.190711,0,0.000002,0.000001,0.5
7192,7192,,40,2,3,5,2,3,5,12,0.185083,0.191785,0,0.000002,0.000003,0.666667
7206,7206,,40,1,1,2,1,1,2,12,0.185012,0.191196,0.000334,0,0.000001,0.5
7212,7212,,40,1,1,2,1,1,2,12,0.185024,0.191225,0.000669,0,0.000001,0
7217,7217,,40,1,2,3,1,2,3,12,0.185047,0.191456,0.000668,0,0.000001,0.333333
7096,7096,,40,1,1,2,1,1,2,12,0.185012,0.191196,0.000334,0,0.000001,0.5
7110,7110,,40,1,1,2,1,1,2,11,0.206556,0.214481,0.000334,0,0.000012,0.5
7236,7236,,40,1,1,2,1,1,2,11,0.206556,0.214481,0.000334,0,0.000012,0.5
7180,7180,,40,1,2,3,1,2,3,12,0.185321,0.192085,0.000334,0,0.000002,0.666667
7205,7205,,40,1,1,2,1,1,2,12,0.170085,0.174172,0,0,0,0
7151,7151,,40,1,1,2,1,1,2,11,0.204899,0.211898,0.000334,0,0.000011,0.5
7165,7165,,40,1,1,2,2,2,4,12,0.184799,0.190734,0.000334,0,0.000001,0.5
7183,7183,,40,1,2,3,1,2,3,12,0.185071,0.191612,0.000334,0,0.000001,0.333333
7187,7187,,40,2,2,4,2,2,4,12,0.185059,0.191554,0.000334,0,0.000001,0.333333
7185,7185,,40,2,2,4,2,2,4,13,0.156203,0.160276,0,0,0,0
7218,7218,,40,1,1,2,1,1,2,12,0.185024,0.191225,0,0,0.000001,0.5
7152,7152,,40,1,0,1,1,0,1,0,0,0,0,0,0,0
7356,7356,,33,0,1,1,0,1,1,11,0.19693,0.204049,0,0,0.000007,0
7368,7368,,34,0,1,1,0,1,1,12,0.181635,0.188237,0,0,0,0
7375,7375,,34,1,1,2,1,1,2,11,0.221872,0.234131,0.000335,0,0.000104,0
